為	làm việc,vị,vy,vi
誰	thùy,ai
緣	duyên,duyến
該	định,cai
寶	qúy báu,báu,bửu,bảo
千	ngàn,thiên,chung thân
義	nghĩa,điều lấy sự hiếu nghĩa
強	mạnh,cưỡng,cường
正	sửa,chính,ngay thẳng,chánh,chinh
納	nạp,xỏ
燬	chê bai,hủy,hủy
詩	thi
余	nhiều,dư thừa,xà,dư
敬	kính trọng,cung kính,kính
存	còn,tồn,giữ
景	ảnh,cảnh
饒	tha lỗi,tha thứ,khoan dung,nhiêu
如	như,bằng
違	làm trái,trái nghịch,tránh,vi,vy
憂	buồn rầu,ưu,lo âu,lo
崩	băng,núi lở
宗	dòng họ,tôn,tông
忠	trung,trung thành
理	lí,lẽ,lý
司	ty,quan,tư,ti
籍	tạ,sách vở,tịch
君	quân,quân vương,vua
虧	khuy,bớt đi
運	vận,thời vận
必	đi ắt phải,ắt,tất,sẽ
恥	sỉ,hổ thẹn
品	phẩm
勢	thế lực,thế
蒼	thưởng,thương,màu xanh,xanh
免	vấn,tránh,thoát,miễn
記	ghi nhớ,ký,kí
孝	hiếu thảo với,hiếu,hiếu thảo
節	tiệt,tiết,tiết tháo
咬	giao,yêu,ăn,giảo
益	phước báo,ích,hữu ích,lợi ích
病	bệnh
哀	ai,thương
nan	nan
損	hại,tổn,mòn
好	hiếu,hảo,tốt
諭	dụ
過	qua,của,qúa
盛	thành,thình,tốt tươi,thịnh,thạnh
勸	khuyến,khuyên
諦	đề,đế,kỹ
富	phú,giàu
晉國	nước tấn
恩	ân
欺	khinh,khi
徐孝徐	từ tiết hiếu
昊	hạo,mênh mông
食	cơm,việc ăn uống,thực,tự
尊	tôn,tôn trọng
勇	ham,đánh nhau,dũng
凶	tai họa,xấu,hung
甚	gì,thậm
水	thủy,nước
清	thanh khiết,thanh tịnh,thanh,sảnh
先	trước,tiến,tiên
莊子	trang tử
聽	thính,nghe,thinh
事	sự,phụng sự,việc
廣	quáng,quảng,khoát,rộng
蔡伯皆	thái bá giai
謂	gọi là,đó gọi là đó,vị,là
迂	vu,suy nghĩ xa xôi
謀	mưu
寒	rét,hàn
長	tràng,trưởng,trướng,nó lớn,bậc lớn,sở trường,trượng,trường
蕙	huệ
親	thấn,cha mẹ,thân
父	cha,phủ,phụ
也	giả,dã,giã,cũng
麼	làm gì,ma
志	chí,ý chí
篇	thiên
問	hỏi,vấn
其	ký,kì,của,kí,ky,nó,kỳ,ki,cơ,cái
改	sửa đổi,cải
觀	quan,quán,xem,xem chuyện
循	tuần,noi theo
和	hồ,hòa nhã,hòa,họa
鞠	cúc,nuôi
作	làm,tác,tá
負	phụ
默	làm thinh,mặc,yên lặng,yên tĩnh,tĩnh
園	vườn,viên
下	hạ,há
失	thất,lỗi,mất,lầm lỗi
恒	cắng,hằng,bình thường,căng
知	biết,trí,tri
鄉	hưởng,hướng,hương,làng xóm
使	sứ,sử,bảo
門	cửa,môn
止	chi,chỉ,dừng
電	điện,tia chớp
身	mình,thân mình,quyên,thân
眼	mắt,nhãn,nhẫn
逆	nghịch lại,nghịch,nghịnh
休	nghỉ ngơi,hưu,hu
淨	tịnh
口	khẩu,miệng
世	thế,thế gian,đời
貪	ái mộ,tham,tham vọng
愼	thận trọng,thận,cẩn thận
啄	miếng ăn,trụ,trác
顧	phụng dưỡng,cố
告	cốc,nói,cáo
十	nan,thập,mười
滿	muộn,mãng,mãn,đầy
哉	thay,tai
難	na,khó,nan,hoạn nạn,nạn
丈	trượng
而	năng,mà,nhi
禍	họa,tai,họa
明	biết,biết rõ,sáng,minh
賢	hiền,hiện,đức
財	tiền,của cải,tài
忍	nhẫn,nhẫn nại,nhẫn nhịn,nhẫn chịu,nhẫn nhục,nhận chịu nhẫn nhịn
瞞	môn,man,lừa
書	sách,thư,kinh thư
聞	vấn,nghe,văn,vặn,cửa
隨	tùy,theo cùng,đi theo,theo sau
之	chi,của
靜	thanh tịnh,tịnh,tĩnh
就	gặp,tụ hợp,tựu
言	ngôn,lời,ngân,lời nói
何	sao,hà,ai
澄	trừng,lắng
色	sắc,sắc đẹp
山	san,núi,sơn
善	thiến,thiện
春	xuân,mùa xuân
嚴	nghiêm trang,nghiêm
即	tức,thì
心	lòng,tâm
齊	tế,tễ,tê,tư,bằng,tề,trai
責	trái,trách
弱	yếu,nhược
子	tý,tí,tử,đức khổng tử
冤	oan
法	pháp
怠	đãi,trễ nãi
五	ngũ,v,nan,năm
伏	phu,phục,bặc,chấp nhận,phúc
一	một,nhất,nan
二	hai,ii,nhị,nan
戰	đánh,chiến
九	chín,cửu,nan,cưu
辜	tội,cô
倦	mệt,quyện
八	bát,tám,nan
木	mộc,cây
妻	vợ,thê,thế
六	lục,nan,sáu
四	bốn,nan,tứ
三	tám,ba,tam,nan,trong ba,iii,tạm
悖	bột,trái,bội
死	chết,sống chết do,tử
七	bảy,thất,nan
國	quốc,đất nước
語	ngữ,nói,ngự,ngứ
寵	nuông chiều,sủng
海	biển,hải
外	ngoại,ngoài
制	áp chế,chế
養	dượng,dưỡng,dạng,dường,nuôi,chỉ dưỡng cái  thân thể
厭	thường được thỏa mãn,chán khi ông,yếm,áp,yêm,yểm,ấp
時	lúc,đúng thời,buổi,thời,thì
百	trăm,mạch,bá,hiếu,bách
環	hoàn,ấy là phép thường tuần
劬	khó,cù
柔	nhu,mềm
最	ấy lớn lắm,tối
所	chỗ,sở,hai điều mà ta mong
芒	mang,mình đang
居	ký,trị,kí,ky,cư,ở
短	đoản,bằng
學	thì sự học,học
嗣	dòng họ,tự
思	tứ,tưởng tới mà chi,tai,tư,suy nghĩ
風	mưa gió,phúng,phong,phóng
乎	hô,hồ,mất
在	tại,lấy
或	hoặc,vực,hoặc có
敢	cảm,dám
賤	kém,hèn,tiện,bần tiện
人	nhơn,người,nhân
是	lấy đó,thị,do,là
平	bình khí hòa,biền,bình
則	là,thì,tắc
笑	gặp lúc cười,tiếu
終	chung,tại
太	thái
盡	chớ nên ỷ,tẫn,tận
可	khả,khắc,thể nào
豆	đậu thì,đậu
折	lại hay gãy,đề,chiết
亡	vong,diệt vong,vô,cửa,lụi bại
我	ngã,ta ta,ta
驕	kiêu,kiêu căng
上	thướng,thượng,nhìn,dưới
吾	của ta nói ta,của ta nói,ngô
蔑	miệt,thế cao chê người thấp kém
非	chẳng,phỉ,phi,không
眾	chúng,mọi,nhiều
毅	nghị,dẫu khỏe gan dạ cũng đừng vì thế hiếp
矜	nên,quan,căng
陰	ám,uẩn,âm,ấm
生	thì cuộc sống,sanh,sinh
守	thú,thủ,thì phải biết nhận  luôn theo
方	mới,bàng,phương,là
夷	làm,di
資	là của cải  bài học  cho,tư
祷	đảo,thì dù cầu đảo cúng bái cũng thoát khỏi
大	lớn,đại,thái,tội nào lớn hơn tội
孫	tôn,cháu,tốn,chưa chắc con cháu
素	tố,được vui với
聰	kẻ thông,thông
防	lúc,phòng
當	đáng,phải,nên,đương,đang
愿	muốn,nguyện
戒	giới,ngăn,hãy
主	vì vậy phải lấy tín ngay thẳng  chủ,chúa,chủ
苦	khổ,đắng,đắng thế nào,cổ
曲	thiên khúc lễ  sách lễ ký,khúc
自	biết,thì tự,tự nhiên,tự
信	thân,tin được,tín,tin
重	tự trọng,trùng,trọng
定	định,đính,sẵn
官	quan cai trị tốt,quan
本	bổn,bản,của mình,bôn
繼	kế,noi theo việc thiện
汙	ô,tiên hắn đã dơ,ố,oa,hu
絕	tuyệt,hại cả
小	nhỏ,tiểu
愛	yêu thương,ái
須	phải,tu,hễ phải hăm hở ái
名	danh
典	điển,sách chép
以	dĩ,tuy
從	tụng,tùng,tung,túng,theo,thung,tòng
物	vật
空	trống không,khống,khổng,không
害	hại,hạt
草	thảo,tạo,cỏ
受	nhận,thụ,thọ,thâu
酒	rượu,rượu trà,tửu
成	thành
畏	úy,sợ,kiêng sợ
分	phân,phần,phận,chia
肖	tiêu,giống,tiếu
報	giáng,ban,báo,báo đáp
傷	hại,thương
馬	mã
會	cối,hội
慾	dâm dục,dục
惟	duy,trọn hết
孜	bo,tư
蛇	xà,sá,rắn,di
萬	vạn
體	thể
妄	vô,vong,vọng,tùy tiện
檢	xét,kiểm
忙	mang,bận rộn
內	trong,nạp,nội
甲	giáp
反	phiến,phản,xem lại,phiên
災	thiên tai,tai
出	đi,xích,xúy,xuất
高	cao
嫉	ghen ghét,tật
愚	ngu,ngu si
耕	cày,cày cấy,canh
揚	khoe khoang,dương,vang
勝	hạnh,thăng,thắng
點	điểm,giọt
足	đầy đủ,chân,tú,đủ,túc
訣	quyết
倚	cậy,ỷ lại,ỷ,kỳ
招	kiêu,thiều,triệu vời,kiều,chiêu,thiêu
王	vượng,vương
頭	đầu
仁	nhơn,nhân từ,nhân
教	giao,dạy,giáo
貧	bần,nghèo
讒	sàm,gièm pha
化	hóa,sinh trưởng,hoa
惠	huệ,phước báo
後	sau,hấu,hậu,sau này
債	trái
但	đán,nếu,đãn
干	can,cán,liên quan
師	sư,thầy
閒	thanh thản,nhàn,gián,rãnh rỗi,gian
夫	phu,phù
遺	để lại,di,dị
憲	pháp,hiến
飲	ngụm nước,ấm,ẩm
農	nông dân,nông
道	đạo,nói,đáo
亦	diệc,cũng
答	đáp
故	cho nên,vậy nên,cố
云	viết,vân
痖	ngọng,á
途	mê đồ,đồ,con đường
勿	vật,chớ
榮	vinh,vinh quang,vinh hiển
由	do,yêu,từ,bởi do
窮	khốn cùng,cùng túng,cùng
旱	thiếu nước,hạn,hạn hán
勤	cần,chuyên cần
弟	đệ,anh,đễ
游	đi,du
矣	hĩ,hỷ,hỹ,rồi
青	thanh,xanh
險	hiểm
豪	sung túc,hào
智	trí,trí tuệ
傲	ngạo,kiêu ngạo
順	thuận theo,thuận
邪	hung tà,da,từ,tà
檐	thiềm,diêm,thềm nhà,mái nhà
保	bảo toàn,bảo
權	quyền
舉	gợi,cử
饑	cơ,đói,ki,ky
位	quan chức,vị
莫	mộ,mịch,mạch,bá,mạc,đừng,chớ
未	mùi,vị,chưa
顯	rạng,hiển
形	hình,thân thể
又	hựu,lại,hữu
諂	siểm,a dua
壽	thọ,sống
激	kích,hất văng,khích
已	đã,dĩ
此	vậy,thế này,thử,thế nọ
罪	tội
安	yên,an
藥	dược,thuốc
且	tồ,thả,thư,mà
應	ưng,ứng
彰	rõ,chương
恕	dung thứ,thứ
算	toán,tín toán
家	gia,cô,nhà
儉	kiệm,tiết kiệm
服	phục
敗	tổn,bại
遠	viễn,viển,xa,viến
慧	tuệ,huệ
患	hoạn,lo lắng
只	chích,chỉ
棄	bỏ,khí
固	kiên cố,cố,bền lòng
孤	cô,lẻ loi
顙	trán,tảng
刻	khắc chế,khắc,hặc
要	yếu,yêu,đòi
敵	địch,thù địch
謙	khiêm nhường,khiệm,khiểm,khiêm
石	thạch,đạn,đá
吉	cát,tốt lành
鬼	qủy
性	tính,tánh
忘	vô,vong,vương,quền
多	nhiều qúa,đa,nhiều
積	tích,tý,tích trữ
動	hành động,động
祭	tế,sái,tế tự
周	châu,vòng,chu
施	thỉ,thí,dị,thi,bố thí,di
深	sâu,thâm
毫	hào,nhỏ
前	tiền,tiễn,tương lai
寧	trữ,ninh,thà
中	trong,trúng,trung
目	mắt,mục
至	tới,chí,đến
藏	tạng,tàng,tránh
役	dịch,lao nhọc
容	dong,bao dung,dung
懦	lo sợ,nhu,nọa
符	bùa,bồ,phù
根	rễ,căn
染	nhiễm
齒	xỉ,cái răng
欲	muốn,dục,cầu
東	đông
譽	khen,dự
壤	nhưỡng
職	xí,dặc,chức
田	điền,ruộng
痛	đau thương,thống
視	thị,xem
耳	nhĩ,tai
緊	khẩn,nhanh
依	y,y theo,ỷ
今	nay,kim
辨	biến,bàn luận,biện,ban,biếm
公	công
尋	tầm,xem lại
飽	ấm no,bão
賊	làm hại,tặc
恢	lồng lộng,khôi
兒	nghê,con trẻ,nhi
費	phí,bỉ,phỉ,phất,bí,tốn
喜	hi,hỷ,hí,vui mừng,hỉ,hý
命	vận mệnh,mệnh
悲	đau thương,bi
規	quy củ,quy
有	hựu,có,dựu,hữu
舍	xá,bỏ qua,xả
喪	tang,táng
辱	nhục
谷	lúa gạo,cốc,dục,lộc
血	huyết,máu
瓜	dưa,qua
求	mong cầu,cầu
屬	thuộc,hình phạt,chú,chúc
古	xưa,cổ
猶	còn,do,dứu
淫	dâm dục,dâm
怕	phạ,phách,sợ
駕	giá,khống chế
博	bác,cờ bạc
市	thị,chợ
遇	gặp,ngộ
倍	lớn,bội
起	khởi,khỉ,dấy khởi
及	theo kịp,cập
辛	cay,tân
危	qụy,liên lụy,nguy
己	mình,kỉ,kỷ
遲	muộn,trí,trì,trĩ
暢	thông suốt,sướng
氣	khất,khí,chí khí
拜	bái lạy,bái
悅	vui thích,duyệt
殃	tai ương,ương
孽	tai họa,nghiệt
曾	tằng,đã từng,tăng
剛	cứng rắn,cương,cang
德	đức
諛	du,bợ đỡ
聾	lung,điếc
滴	giọt,chích,tích,trích
借	mượn,tá
談	nói,đàm
譎	dối trá,quyệt
飛	bay,phi
昧	tối tăm,muội,mạt
處	xứ,xử,ở
避	tị,tỵ,tránh
始	thỉ,bắt đầu,thủy,thí
藝	nghệ,nghề
瘖	câm điếc,âm
辯	biến,biện,biện luận,phán,bạn,biếm
网	lưới,võng
謗	báng,nói xấu
警	cảnh,cảnh tỉnh
迷	mê
駑	nô,con ngựa
然	vậy,nhiên
鞭	roi vọt,tiên
放	phỏng,qua,phương,phóng
曰	viết
吃	cật,ăn,ngật
擇	trạch,chọn lựa
別	phân biệt,biệt
欽	khấm,khâm,kính
刀	dao,đao
威	uy,oai,oai nghiêm
濟	tế,tể,giúp
蕹	ủng,ung
銪	hữu
馕	năng,nang,hướng,nãng
壠	lũng
煣	nhữu
鮋	trừu,du
滃	ổng
偲	ty,tai,ti
掂	điểm,điếm,điêm
亵	tiết
碁	kỳ,kì
鸹	hộc,cốc,quát
黄	hoàng,huỳnh
愀	thiểu,sậu
慈	tư,từ
諍	tranh,tránh
擕	huê
钬	hỏa
两	lạng,lưỡng,lượng
嗺	thôi
层	tằng
裶	phi
趺	phu
凭	bẵng,bằng
駙	phò,phụ
搧	phiến,thiên
峷	trăn,sân,thân,trân
灓	loan
欤	dư
刾	thích,thứ
蘘	nhương
撏	triêm,trâm,tầm
脧	tuyên,thôi
織	chí,xí,chức
奈	nại
茲	tư,từ
贪	tham
倥	không
粹	túy,toái
葦	vy,vĩ
竞	cạnh
隼	chuẩn
暀	vưởng
嗫	chiếp,nhiếp
揺	dao,diêu
谯	tiều,tiếu
湣	hôn,mẫn
駗	trân
昺	bỉnh,bính
瀇	oảng,quảng,hoảng
缮	thiện
磷	lân,lấn
谥	thụy
雠	thù
祗	chi
逴	xước,trác,sước
冹	phu,phất
瑬	lưu
饊	tản,tán
蜱	bi,tỳ
怪	quái
珽	đĩnh,thỉnh
柘	giá,chá,chạ
簔	thoa,xoa
勍	kình
嶮	hiểm
临	lâm,lấm
椰	da,gia
踔	xước,trác
胔	tích,tý,tí,tỳ
闢	phách,tịch
杷	ba,bá,bà
醎	hàm
葺	tập
螄	sư,tư,si
螹	tiệm
猘	chế
縫	phúng,phùng
郿	my,mi
頂	đính,đỉnh
陆	lục
帲	bình
奖	tưởng
并	bính,phanh,bình,tịnh,tinh,tỉnh,tính
谕	dụ
醃	yêm
訞	yêu
礃	chưởng
缚	phọc,phược
磣	sẩm,sầm
亥	giai,hợi
犬	khuyển
尥	bào,liệu
斤	cấn,cân
劗	tiễn
噢	úc,ủ,ẩu
錟	đàm,tiêm
棧	trản,xiễn,trăn,chăn,sạn
冗	nhũng
銹	tú
旟	dư
侄	trất,chất,điệt
廟	miếu
限	hạn
滇	điên,điền
備	bị
殽	hạo,hào,hiệu
遊	du
賈	giá,giả,cổ
秧	ưởng,ương
顉	khâm
媠	đọa,nọa
槨	quách
毛	mao,mô
蕁	đàm,tầm,kiền
哩	lí,ly,lý
艷	diễm
哈	hà,cáp,ha
玹	hiền,huyền
鏷	bộc
貊	mạch
捂	ngộ,ô
背	bắc,bối,bội
慕	mộ
苌	trường
獶	não
嗇	sắc
鬅	bằng
斜	tà,gia
罩	trạo,tráo
蜈	ngô
醠	ưởng,áng
莾	mãng
螘	nghị,nghĩ
銒	bính
罈	đàn,đàm
鳓	lặc
臂	tý,tí
庪	qủy
热	nhiệt
嵚	khâm
歕	phún,phun
匝	tạp,táp
糚	trang
虒	ty,tư,ti
哎	ai,ngải
挑	thiêu,khiêu,thiểu,thao
俄	nga
郳	nghê
訚	ngân
忡	sung,xung
揮	huy
很	ngận,hẫn,khấn
膂	lữ
逈	huýnh,quýnh
渥	ốc,ác
敶	trần
寮	liêu
芺	ảo
檯	thai,di,đài
彫	điêu
踶	đề,trì,trĩ,đệ
脘	oản,quản
杜	đỗ
棍	hỗn,côn
翬	huy
炤	chiểu,chiếu,chiêu
践	tiễn
摎	lưu,cưu
跰	kiển,nghiễn,bính
迥	huýnh,quýnh
鶉	thuần
隟	khích
僩	giản,gián,dản,nhàn
悻	hãnh
錞	đội,thuần,đỗi,đối
壶	hồ
舐	thị,thỉ,để
蒞	lị
幟	xí
锧	chất
尼	nệ,nặc,nê,ni,nật
熗	sang
廚	trù
缙	tấn
欻	huất,hốt
虰	đinh
慳	san,khan,xan
阁	các
厳	nghiêm
价	giá,giới
槍	sanh,sang,thương
变	biến,biện
锯	cư,cứ
嘐	giao,hao
禋	yên,nhân
棐	phỉ
竆	cùng
膞	thuần,thuyền
棬	khuyên,quyền,quyển
浣	hoán,cán
儠	liệp
暘	dương
鴞	hiêu,hào
祀	tự
計	kế,kê
啉	lâm,lam
杳	yểu,liểu,liễu,diểu
镒	dật
蕲	kỳ,cần,kì
忝	thiểm
蠨	tiêu
樟	chương
竒	kỳ,kì
筯	trợ,trứ
咇	biết,tỵ,biệt,tất
往	vãng
惽	muộn,hôn
虩	khích,hách
颮	phác,bào
惕	thích,dịch
黮	trẩm,thản,đảm,thảm,đạm
簬	lộ
率	suất,soát,luật,lô,súy
藟	lũy
饿	ngã,ngạ
惈	qủa
凊	thính,thảnh,sảnh
悠	du
缐	tuyến
眭	huê,khôi,tuy
跞	lịch,lạc
厷	quăng,hoành
搷	điền,chẩn
𫍲	tẩu
忼	khảng
埏	duyên,thiên,diên
灘	than
憺	đam,đảm
鐓	đối,đỗi,đôi,đồi,đôn
卄	nhập,chấp
魾	phi,bì
繕	thiện
絛	thao
嬥	điệu
庶	thứ
奢	xa
眯	mễ,mị,mê
翟	trạch,địch
坉	đồn
椅	y,ỷ,kỷ
輑	khuân
莲	liên
覚	giáo,giác
约	ước,yêu
艶	diễm
栖	tê,tây,thê
於	ư,ô
鸂	khê
渲	tuyển,huyên
捄	cứu,cầu
隄	đê
魌	khi
靡	mi,mĩ,my,mị,ma,mỹ
湠	thán
嚣	hiêu
鎂	mĩ,mỹ
绘	hội
茀	phất,bột
致	trí
窄	trách
礛	lam
校	hào,giáo,hiệu
滺	du
边	biên
粰	phu,phù
襭	hiệt
娀	tống,tung
袠	trật,dật
疣	vưu
豹	báo
庵	am
鈆	duyên,diên
酝	uẩn,ôn,ổn,uấn
甦	tô
宙	trụ
跪	qụy
睭	chửu
实	thật,thực
瀱	kế
櫫	trư
卅	tạp,táp
撩	liêu,liệu
掺	tiêm,sam,tham,sảm
洒	thối,tẩy,sái,tiển
厛	thính,sảnh
散	tản,tán
殀	yểu
窉	bính
匑	cung
读	đậu,độc
脚	cước
鶰	viên
删	san
蛩	củng,cung,cùng
噯	ái,ai,ải
餜	qủa
霜	sương
眷	quyến
葷	huân
矓	lung
傴	ủ
摑	quắc,quách,quốc,quặc
货	hóa,thắc,thải
畠	tai,tri
综	tống,tổng,tông
佼	giao,giảo
懒	lại,lãn
账	trướng
险	hiểm
绾	oản
攀	phan,phàn
產	sản
樅	tung
阑	lan
鮭	khuê,hài
靄	ái,ải
銩	đâu
嶠	kiêu,kiệu,kiều
這	giá,nghiện
咚	đông
蒗	lạng,lãng
鄞	ngân
违	vy,vi
徕	lại,lai
攔	lạn,lan
潚	tiêu,túc
献	hiến
筜	đương
頻	tần
紲	tiết,sế
洹	hoàn,viên
蛙	oa
脑	não
啙	tử,tỳ
矗	xúc,súc,sốc
泆	dật
蕊	nhụy,nhị
朴	phu,phác
偰	tiết
韥	độc
頡	kiết,hiệt,giáp
横	hoạnh,quáng,hoành
嗿	thám
熷	tăng
𦒦	lạp
獘	bệ,tệ
睡	thụy
揗	thuẫn,tuần
甫	phủ
蟥	hoàng
舼	cung
庖	bao,bào
旎	nị,nỉ,ni
濯	trạo,trạc
漲	trướng
朋	bằng
遵	tuân
肬	vưu
筑	trúc
墈	khám
杝	trĩ,di,kỷ
緯	vị,vĩ
秘	bí
莧	hiện
熔	dong,dung
喽	lâu
溈	duy,quy,vy
狮	sư
彚	vựng,vị
眺	diểu,thiếu
酯	chỉ
埋	mai,man
叚	giá,giả
劑	tề,tễ,tệ
贑	cống,cám
纹	vấn,văn
膩	nị,nhị
传	truyền,truyện,truyến
媯	quy
颀	kỳ,kì,khẩn
銨	an
露	lộ
醌	côn
彌	my,nhị,di
颿	phiếm,phàm
叶	hiệp,diệp
鍜	hạ
奴	nô
驤	tương
馘	quắc,hức
齆	úng
槁	cảo,khao,cao,khảo
耼	đam,tham
宠	sủng
掞	thiểm,diễm,diệm
嵔	uy,ủy
塀	bính
瞎	hạt
俽	hân
譝	thằng
梌	đồ
鱍	bát
坻	chỉ,để,trì,chì
䏝	thuyền,thuần
懿	ý
鼒	ty,tỷ,tư,tỉ,tài
覲	cẩn,cận
薤	giới
贲	phần,bí,bôn
渜	noãn,nhuyên
絳	giáng,ráng
埚	oa,qua
鎸	tuyên
騩	qủy,quy
份	phân,bân,phần
祧	thiêu,dao,diêu
酨	tải,đại
伎	ky,kĩ,kỹ
炰	bào
跫	củng,cung
貉	mạch,hạc,lạc,hào,mạ
韱	tiêm
紞	đảm,đãn
爲	vị,vy,vi
悌	để,đễ
喟	vị
蔫	yên
炘	hân
韒	tiếu
汽	khí,hất,ất
堄	nghê,nhị
鯫	tẩu,tưu,xu
裨	ty,tì,bì,tỳ
茥	khuê
楖	trất
筹	trù
絢	huyến
抖	đẩu
闐	điền
諴	hàm
谦	khiệm,khiêm
粽	tống,tông
咧	lệ,liệt
湉	điềm
譠	đản
鈜	hoành
頳	trinh,xanh
瓣	biện
鑸	lỗi
簫	tiêu,tiểu
獻	ta,hiến
瀧	lung,sang,lang
鎲	đảng
喝	hát,ái,ới,hạt
礪	lệ
兑	đoài,đoái
緝	tập
洙	thù,chu
贰	nhị
婷	đình
鍱	hiệp,diệp,tiết
瀅	oánh,uynh,huỳnh
参	xam,sâm,tam,sam,tham
涴	ô,oản,ngọa,uyển,uyên
攐	khiên
狙	thư
浃	tiếp,giáp
齳	ngẫn
韓	hàn
袹	mạt
芚	truân,xuân,đồn
绷	banh,băng,bắng
耷	đạp,đáp
旇	phi,mỹ
薩	tát
颈	cảnh
脍	khoái,quái
揉	nhu,nhụ
帴	tàn,tiễn,tiên
絜	kiết,khiết,hiệt
茨	tì,từ,tỳ
頷	hạm,hàm
嬖	bế
闇	ám,am,yểm
贯	quán
攲	khi
龐	bàng,lung
糊	hồ
奙	bổn
墰	đàm
㧏	cương,cang
冒	mặc,mạo
貸	thắc,thải
脓	nung,nùng
幢	chàng,tràng
戤	ngái,khái,cái
琬	uyển
汒	mang
濭	ái
剚	chí,trí,tứ
紵	trữ
錵	hoa,họa
氜	dương
怡	di
葘	truy,tai,tri
鉿	cáp
漥	oa
団	đoàn
淹	yêm,yểm
箄	tỳ,tị,phỉ,bài
碰	binh,bánh,bính
嗒	tháp,đáp
蹭	thặng
銳	duệ,nhuệ,đoái
弒	thí
术	truật,thuật
搾	trá
構	cấu
慰	úy,ủy
釱	đại,đệ
冁	sản,xiên
响	hưởng
靨	yểm,yếp
鴆	chậm,trậm,trấm
賻	phụ
湲	viên
洟	di,thế
毋	vô,mưu
騱	hề
魄	phách,bạc,thác
埵	đóa,đỏa
笣	bao
娪	ngư,ngô
酖	đam,chậm,trậm,trấm,trầm
駱	lạc
繂	luật
狇	mộc
㣘	câu
騂	tinh,tuynh
侏	thù,chu
捼	nhoa,nôi,noa
楗	kiện,kiển
狧	tháp
憱	xúc,túc
禜	vinh
渾	hỗn,hồn
窟	quật
盩	châu,chu,trưu
桅	ngôi,nguy
鏸	huệ
雷	lôi,lỗi
遥	dao,diêu
蚆	ba
决	huyết,quyết,khuyết
否	bỉ,bĩ,phầu,phủ
甕	úng,ủng,ung
垩	ác
璀	thối,thôi
蔣	tưởng,tương
佁	tỷ,sỉ
頦	cai,hài
搤	ách
孖	tư,ma
箸	trợ,trứ
愵	nịch
艑	biển,biện
副	phó,phốc,phức
瞢	mộng,măng,mông
閧	hống
捩	lệ,liệt
镫	đặng,đăng
稅	thối,thoát,thuế
鈮	ni
旺	vượng
緧	thu
搠	sóc
醓	thản,thảm
紾	khẩn,chẩn,diễn
坫	điếm
鰩	dao,diêu
餾	lựu,lưu
亞	á,a
髦	mao
澐	vân
衛	vệ
俶	thục,thích
搬	ban,bàn
鋐	hoành
椵	giả,gia
造	tạo,tháo
柈	bàn,bán
鷿	tịch
趼	kiển,nghiễn
煼	sao
皓	hạo,cảo,cáo
裩	côn
僻	tích,tịch
蒮	dục
璅	tảo,tỏa
癧	lịch
仔	tử,tể
倮	khỏa,khõa,lõa
蹲	tồn,tỗn,thuẫn
駾	thoái
鞋	hài
嶋	đảo
僮	đồng,tráng
請	tình,tính,thỉnh
椭	thỏa
旬	quân,tuần,quyên
髕	tẫn,bận
钃	chúc
彽	đê
伧	sanh
昕	hân
拂	phất,bật,phật
疁	liêu
姼	thi
褹	nghệ
亲	thấn,thân
扱	hấp,tháp,tráp
鞘	sao,tiếu
痞	bĩ
竇	đậu
鬗	man
峿	ngữ,ngô
儷	lệ
嬽	oan,huyên
訴	tố
阨	ách,ải
鋡	hàm
裸	khõa,quán,lõa,lỏa,khỏa
嗔	sân,điền
滟	liễm,diễm
浇	kiêu,nghiêu
吓	hạ,hách,nha
嘺	khiêu,kiệu,kiều
鞻	lâu
頸	cảnh
犪	qùy
滑	cốt,hoạt
頀	hộ
㨪	hoảng
朧	long,lung,lông
跣	tiển,tiên
夙	túc
雏	sồ
竹	trúc
玺	tỷ,tỉ
襡	thục,độc
講	giảng
喈	giai,dê
縚	thao
歓	hoan
弭	mị,nhị
癥	trưng
簀	trách
懁	hoàn,hoài
韈	vạt,mạt,miệt
變	biến,biện
晊	chí
釭	công,cang
县	huyện,huyền
咀	tứ,tữ,trớ,tư,chủy
陏	đọa,tùy
飘	phiêu
仇	câu,cừu
錕	côn
詟	triệp
蟊	mâu
閈	hãn
痀	câu,củ
毙	tễ,tệ
晼	oản,uyển
乇	thác,trách
媕	am,an,yểm
屉	thế
哫	túc
鄑	tấn
魯	lữ,lỗ
捺	nại
尷	dam,giam
嘮	lạo,lao
陶	giao,dao,đào
虑	lự,lư
湇	khấp
癹	bát
铭	minh
虿	mại,sái
契	khất,khế,khiết,tiết
筛	sư,si
嚲	đả
鸀	chúc
菶	bổng
餔	bộ,bô
姍	san,tiên
墜	trụy
弶	cương
糟	tao
圜	hoàn,viên
跂	kì,kĩ,xí,kỳ,khí,kịch
猟	liệp,lạp
亨	hưởng,phanh,hanh
筦	quản
伙	hỏa,khỏa,lõa
坏	hoại,hoài,bôi,khôi,nhưỡng,bùi,phôi
漸	tiềm,tiệm,tiêm
鈧	kháng
碔	vũ
檮	đào
煠	sáp
族	thấu,tộc,tấu
帵	oan,uyên
螋	sưu
辰	thìn,thần
郸	đan
羙	mỹ
爹	đa,đà
粮	lương
翤	sí
嗓	tảng
犸	mã
汆	tù,thoản,thộn
築	trúc
湊	thấu,tấu
澼	phích,tịch
聘	sính
羊	tường,dương
侵	tẩm,xâm,thẩm
眢	oan,uyên
簵	lộ
敌	địch
玦	quyết
闶	kháng,khang
铵	an
標	tiêu,phiêu
嗦	sách,thoa
蕫	đổng
鎰	dật
輺	tri,truy
捆	khổn,hồn
拊	phu,phủ,phụ
橦	sàng,đồng,tràng
覜	diểu,thiếu
侠	hiệp
陕	xiểm,thiểm,hiệp
淳	thuần
籤	thiêm,tiêm
舡	hang
逫	quyết,truất
轤	lư,lô
頖	phán
溰	nghi
阤	đà,trĩ,dĩ
阓	hội
熘	lựu
糂	tảm
茻	võng,mãng
畨	phiên
躅	trạc,trục
掯	khẳng
哺	bu,bộ,bô
𫓱	kiều
掆	cương,cang,giang
帗	phạt,bạt
譔	soạn
塘	đường
蓳	cẩn
疋	nhã,sơ,thất
栅	san,sách
哅	hung
鼇	ngao
膟	suất
尃	phu
窸	tất
菌	khuẩn
啤	ty,bì,ti,tỳ
獷	quáng,quánh,quảng,cảnh
察	sát
藶	lịch
松	tung,tùng,tông
礽	nhưng
椄	tiếp
娇	kiều
苴	trư,trạ,bao,tra,thỏ,tô,thư,tư
亟	khí,cức
肛	soang,giang,xoang,khang,cương
幸	hạnh
純	truy,đồn,tuyền,chuẩn,thuần
偻	lũ,lâu
潙	quy,vy
頎	kỳ,kì,khẩn
翼	dực
狋	nghi
锄	sự,sừ
灬	hỏa
皿	mãnh,mẫn
帆	phâm,phàm
贛	cảm,cống,cám
栎	lịch,lao
间	dản,gián,gian,nhàn
芗	hương
犹	do,du,dứu
汰	thái,thải
畯	tuấn
憩	khế
酺	bộ,bồ,bô
覥	điễn,điển,điến,diễn
鲕	nhi
禘	đế
柢	đế,để
涡	oa,qua
铔	á,a
鎗	sanh,thương,sang
跳	khiêu,đào
拏	nã,noa
鰥	quan,côn
袂	duệ,mệ
惘	võng
誦	tụng
祝	chú,chúc
艾	nghệ,ngải
泏	truất
儃	thản,bồi
刄	lạng,lượng
薨	hoăng,hoằng
峗	qụy
觅	mịch
硠	lang
体	thể,bổn
窯	dao,diêu
敝	tệ
扩	khuếch,khoáng,khoác,khoách
錪	điển
邹	trâu
活	hoạt,quạt
鯸	hầu
認	nhận
笋	tuân,duẫn,duẩn,tuẩn
僥	kiểu,nghiêu
橫	hoạnh,quáng,hoành
沛	bái,phái
铦	thiểm,tiêm
马	mã
夆	phùng,phong
褪	thoái,thốn,thối
傉	nục
萚	thác
逼	bức
燠	ủ,áo,úc,ốc,ứ
蜊	lị,ly,lợi
刱	sang,sáng
囯	quốc
懤	trù
阿	ốc,á,a
婼	xúc,xước,nhược,nhi
怀	phó,hoài,phụ
嗯	ân
澜	lan
牂	tang
琉	lưu
擷	hiệt
臙	yên
咂	táp
速	tốc
莝	tỏa
儤	bạo
鸷	chí
瘤	lựu,lưu
冰	băng,ngưng
驦	sương
廉	liêm
悞	ngộ
蝍	tức
灡	lan
蓠	ly,li
曌	chiếu
雍	úng,ủng,ung
甯	ninh,nịnh
萊	lai
痻	mân
獽	nhương
夭	yểu,yêu
褞	ôn,uấn
鋄	vạn
丞	chưng,chửng,thừa
値	trực,trị
阴	âm,ấm
裒	bầu,bật,phầu
釶	thi,tha
撻	thát
疿	phí,phi
葌	gian
轄	hạt
匂	cái
綢	thao,trừu,trù
詿	quái
这	giá,nghiện
懋	mậu
懲	trừng
綏	thỏa,nhuy,tuy
嵸	tung
囊	nang
玞	phu
濁	trọc,trạc
沈	trầm,thẩm,trấm
砳	lặc
蜀	thục
蔪	sam,tiêm
襟	khâm
嚜	mặc,muội,ma
怗	chiêm,thiếp,siêm
觜	tủy,tư,chủy,tuy
替	thế
韋	vy,vi
垧	quynh,thưởng
攪	cảo,giảo
蓦	mạch
傯	tổng
跐	thử,thải
蘴	phong
孏	lãn
崪	tụy,tột,tốt
梱	ngôn,khổn,khốn
鳊	biên
裕	dụ
糖	đường
瀋	trầm,thẩm,trấm
鞾	ngoa
豗	hôi
伲	nễ
貔	tì,tỳ
歆	hâm
蠭	phong
櫂	trạo,trạc
呛	sang,thương
飱	san,tôn,sôn
哰	lao
櫉	trù
郡	quận
琛	sâm
鋁	lự,lữ
鬽	mị
漘	thần
偄	noàn,nuyên
缧	luy
叙	tự
鉏	sừ,tra,từ,tư,trở
猞	xá
賁	phẫn,phẩn,phần,bí,bôn
嬲	điểu,niễu,niểu,điều
泣	khấp
裌	giáp
搂	lâu
桴	phu,phù
謈	bạc,bào
廢	phế
睾	cao
氽	thận,thộn,thoản
鼙	bề,bế
蓧	thiểu,điệu,địch,điếu,điều
鼋	nguyên,ngoan
鞗	điều
穩	ổn
耿	quýnh,huỳnh,cảnh
颢	hạo,hiệu
苲	trả
磻	bàn,bà
佻	diêu,điệu,thiêu,khiêu,dao,điểu,điêu
骻	khỏa,khóa
赵	triệu
纜	lãm
牒	điệp
溛	oa
橜	quyết
轖	sắc
虮	kỉ,kì,kỷ
鸪	cô
崎	kỳ,khi
夹	kiếp,giáp
啦	lạp
斄	ly,li,lai
齋	trai
猭	duyên,thiên,chuyên
褥	nhục
苇	vy,vĩ,vi
了	liễu,liệu
騵	nguyên
滥	cãm,lạm,lãm
卧	ngọa
邿	thi
鹈	đề
酥	tô
齀	ngột
瓻	hy,hi
姫	cơ
揍	thấu,tấu
颣	lỗi
漓	ly,li
睊	quyến
沏	thiết,thế
罧	sâm
蒔	thi,thì
麢	linh
穰	nhương,nhưỡng
疻	chỉ
獎	tưởng
诠	thuyên
痔	trĩ
獟	hiêu,nghiêu
茜	tê,trệ,thiến,tây
鲍	bão,bào,bảo
頾	tư,tỳ
塢	ổ
宝	bửu,bảo
殮	liệm,liễm
纨	hoàn
慷	khảng
棣	lệ,đại,đệ,thế
跩	duệ,thế
樊	phiền,phàn
嶞	đọa
謝	tạ
醣	đường
皖	hoàn,hoán,hoãn
宏	hoằng,hoành
趋	xúc,xu
讌	yên,yến
燔	phần,phiền
攌	hoàn
谮	tiếm,trấm
咆	bào
蔹	liêm,liễm
揝	tản,toản
愲	cốt
踴	dõng,dũng
阵	trận
鋏	khiếp,kiệp,giáp
鬁	lị,thích,lợi
越	hoạt,việt
帓	mạt
摧	thôi,tồi,tủy,tỏa
醪	giao,dao,lao
莛	đình
蘆	lư,lô
逭	hoán
鲸	kình
纁	huân
捍	tốc,hãn
殕	phẫu,phủ
拓	tháp,chích,thác
募	mộ
催	thôi
嶒	tằng
黏	niêm
刨	bào
刪	san
卲	thiệu,thiều
洩	duệ,tiết
柮	đóa,đốt
累	luy,lũy,lõa,lụy
兕	hủy
嵎	ngu,ngung
噫	y,ái,ức,ý
楕	thỏa
驗	nghiệm
胇	phế,bái
呒	mô
侪	sài
茕	quỳnh
畬	xa,dư
螵	phiêu
説	duyệt,thuyết,thuế
徨	hoàng
瞪	trừng
囁	chiếp,nhiếp
指	chỉ
濑	lại,lai
惷	xuẩn
蜞	kỳ,kì
瘑	qua
牣	nhận
痺	ty,tý,tê,tí
擸	tạp,liệp,lạp
酔	túy
麾	huy
竁	xuyến,xuế
桄	quang,quáng
牽	khiên,khản
壥	triền
鋰	lý
剺	ly,li
埌	lãng
舀	yểu,du
枱	cử,di,đài
灩	liễm,diễm
蔡	sái,thái,tát
珦	hướng
搶	thưởng,thảng,thướng,sang,thương,sanh
府	phủ
晟	thịnh,thạnh
盧	lư,lô
蹫	quỳnh
嚐	thường
嚱	hy,hi
薯	thự
矲	bả,bái
裰	chuyết,xuyết
鶡	hạt
躬	cung
桿	can,hãn
椑	tích,bế
鯗	tưởng
篎	miểu
圹	khoáng
瞰	khám
隐	ấn,ẩn
櫎	hoảng
雇	cố
飔	ty,ti
婵	thiền,thuyền
歜	xúc
愨	khác,xác
柴	tứ,sài,si,tý,tái,trại
濜	tận,tấn
垒	lũy,luật
尨	mang,mông
洸	quang,hoảng
殯	thấn,tẫn,tấn
逦	lị,lệ
薄	bác,bạc
餫	hồn
蜡	chá,trá,thự,thư,lạp
售	thụ
煝	my
椗	đĩnh,đính
踸	sẩm
相	tướng,tương
睕	uyên
適	đích,địch,thích,quát,trích
琭	lộc
睖	lăng
汋	chước,thược
墮	huy,đọa
枉	uổng
摍	súc
笢	mân
朽	hủ
蜮	vực,quắc,quách
錜	niệm
疳	cam
净	tịnh
韛	bộ,bại,bị
首	thú,thủ
錁	qủa
恌	thiêu,khiêu,dao
华	hoa,hóa
齍	tư
鄲	đan
鹕	hồ
瀀	ưu
爼	trở
漕	tào
鵝	nga
齇	tra
擺	bài,bãi
皃	mạo
角	cốc,lộc,giác,giốc
顖	tín
瞑	miên,minh,miễn
狁	duẫn,doãn
鲶	niềm,niêm
农	nùng,nông
櫝	độc
狴	bệ
锜	ky,kĩ,ki,kỹ
诺	nặc
鬢	mấn,tấn
缶	phũ,phẫu,phữu
厱	lam
珙	củng
毘	tì,bì,tỳ
寪	vị,vĩ
柹	thị,sĩ
績	tích
伥	trành
鱸	lư,lô
赛	tái,trại
差	sai,tha,si,soa,ta,sái
妦	phong
偁	xưng,xứng
噍	tiêu,tưu,tiếu
厊	nhã
繤	toản
汀	đinh
纇	lỗi
價	giá,giới
䎱	bá
吱	chi,khi,tư
紓	thư
鱗	lân
餺	bác
颹	vĩ
挃	trất
冕	miện
拄	trụ
勯	đan,đàn
拯	chủng,chửng
齞	nghiễn
儂	nùng,nông
咔	ca
惬	khiếp,thiếp
洑	phục
窋	truật,quật
挛	luyến,luyên
莹	oánh
建	kiến,kiển
齼	sở
暝	mịnh,mính,minh
兌	duệ,nhuệ,duyệt,đoài,đoái
淙	tông
桲	bột
庄	bành,trang
樵	tiều
枪	sanh,sang,thương
羴	chiên,thiên
毗	tỳ,tì,bì
挢	kiểu,kiệu,kiều
霎	sáp,thiếp,siếp
夅	hàng
趻	sẩm,trần
胈	bạt
柱	trụ,trú
䴘	đề
汮	quân
汃	bân,bẩm,bát
姆	hối,mỗ,mẫu
诊	chẩn
哄	hống
瀁	dưỡng,dạng
鱄	chuyên,đoàn
帯	đái,đới
殡	thấn,tẫn,tấn
襕	lan
痤	tọa,toa
翑	cù
鼮	đình
圁	ngân
賃	nhẫm,nhấm
娘	nương
汍	hoàn
脱	thoát,đoái
頵	quần
苿	mạt
乾	càn,can,kiền
儳	sàm,sảm
峋	tuân
櫧	chư
営	doanh,dinh
輸	thú,thâu,du
軼	điệt,triệt,dật
野	dã
蝂	bản
沤	ẩu,âu
瞳	đồng
串	xuyến,quán
例	lệ
隮	tề,tê,tễ
处	xứ,xử
摈	bấn,thấn,tấn
襖	áo
隞	ngao
仉	chưởng
媆	nhuyễn,nộn
瓮	úng,ủng,ung
窕	thiêu,dao,điệu
雊	cấu,cẩu
汩	mịch,dật,hốt,duật,cốt
約	ước,yêu
奼	xá,sá
祁	kỳ,kì
乒	binh
帏	vy,vi
烴	hĩnh,thinh,kính
枓	đẩu,chủ,đấu
歫	cự
輳	thấu
繅	tao,tảo,sào
臮	ký
桶	dõng,thũng,dũng
譍	ưng,ứng
螝	hủy,hối
選	toán,tuyển,soát,tuyến,toản
逬	bình,bính
蛱	hiệp,kiệp,giáp
譖	tiếm,trấm
淛	chiết
耜	tỷ,cử,tỉ
塙	xác,sác
暂	tạm
偿	thường
肨	bàng,bang,bàn
貆	hoàn,hoan
营	doanh,dinh
塹	tiệm,tạm
镁	mĩ,mỹ
趢	lộc
麝	xạ
闍	đồ,xà
蘞	liêm,liễm
听	thính,ngân,dẫn
蓼	lục,liễu,liệu
袆	y,huy
詹	chiêm,đạm
比	tỷ,bỉ,tỉ,tỵ,bí,bì
搥	trùy,đôi
鑽	toàn,toản
回	hồi,hối
鳐	dao,diêu
恶	ác,ố,ô
獍	kính
𡰿	súc,bộc,cục
柵	san,sách
畦	huê
冱	hộ,hỗ
哶	mã
櫥	trù
躪	lận
課	khóa
釐	hy,ly,li,hi
薈	hội,oái
絻	vãn,vấn,miện,miễn
酢	thố,tạc
錢	tiền,tiễn
荦	lạc
眦	tý,trại,tí,xải
葒	hồng
琳	lâm
椾	tiên
膙	cưỡng
蘧	cù,cừ
驝	thác
履	lí,lý
锤	chùy,chúy
躇	trừ,xước,trù,sước
吸	hấp
訋	hồng
行	hãng,hàng,hạng,hành,hạnh
去	khử,khứ,khu
懶	lại,lãn
茏	long,lung
繇	do,chựu,diêu,dao,lựu
猪	trư
妓	kĩ,kỹ
奧	úc,áo
堂	đàng,đường
漁	ngư
篑	qũy
鼧	đà
耧	lâu
踆	tồn,thuân
猺	dao
瑴	giác
飴	di,tự
璇	tuyền
丼	tỉnh,đảm
哮	hao
磔	trích,trách
錦	cẩm
緙	khách
芐	hạ
狃	nữu,nứu
倯	tùng
摸	mạc,mô
徳	đức
袨	huyễn
墡	thiện
渼	mĩ,mỹ
仪	nghi
怚	thư,tự
誶	tối
鞨	mạt,hạt
彆	biệt,tệ
若	nhã,nhược
掰	phách,bai,bài
谖	huyên
耥	thảng
座	tọa,tòa
凳	đắng
藸	trư,chư
囪	thông,song
勑	sắc,lại,lai
硃	châu,chu
淡	đạm,đàm
飧	san,tôn,sôn
敂	khấu
闪	siểm,thiểm
罋	úng,ung
琯	quản
补	bổ
袙	mạt
焭	quỳnh
匌	cáp
嚘	ưu
呀	a,nha
剒	thố
瘚	quyết
溯	tố
弊	tế,tệ,tiết
皙	tích
洏	nhi
媵	dắng,dựng
桮	bôi
禧	hy,hi
腦	não
龛	khám,kham
襻	phán
苙	lập
盇	hạp
訑	nãn,tha,đản,đà,di
氲	uân
珑	lung
墯	đọa
篰	bộ,bậu
梨	lê
菘	tùng
啑	xiệp,xiếp,tiệp,điệp
辉	huy,huân,vận
臆	ức
讠	ngôn
笇	toán
磾	đê,đạn
泾	kinh,kính
庳	ty,tì,bỉ,tý,bí,tỳ
篨	trừ
緻	trí
齠	điều
磇	tỳ
隑	kỳ,ngai
瀆	đậu,độc
筈	quát
屰	nghịch,kích
韬	thao
趹	quế,quyết
耡	sự,trợ,sừ
驳	bác
僇	lục
㥯	ẩn
茄	già,cà,gia
慴	chiếp,triệp,chiệp,điệp,nhiếp
鲫	tức
歬	tiền
忴	liên,linh
槲	hộc
轂	cốc
羾	hồng
私	tư
熾	xí,sí
团	đoàn
隒	nghiệm
鮯	cáp
迭	điệt,tuyển
聑	tie1,điệp
疚	cứu
鱺	lễ,ly,li
爐	lư,lô
忾	hất,hy,khái,hi,khải
馨	hấn,hinh
歂	suyễn,thuyên
效	hiệu
硪	ngã,ngạ,nga
敛	liệm,liễm
瑙	não
撋	nhuyên
墳	bổn,phần,phẫn
僣	thiết,tiếm
亮	lương,lượng
懌	dịch
湫	tiều,tiểu,tưu
紒	kế
岣	cu,cẩu
邶	bắc,bội
霂	mộc
徂	tồ
莸	do,du
臈	lạp
堽	cương
摁	ân
臻	trân,trăn
赧	noãn,noản
臃	ủng,ung
觳	hộc,hạc,giác,xác
痼	cố
紅	công,hồng
齌	tễ
繊	tiêm
旸	dương
甸	điện,thịnh,điền
甥	sanh,sinh
瀿	phiền
觴	thương,tràng,trường
墧	xác,kiều
跔	câu
诔	lụy,lỗi
箜	không
嚩	phạm,phạ,phược
蹎	điên
扦	thiên,hãn
纖	tiêm
乗	thặng,thừa
緄	hỗn,cổn
闳	hoằng,hoành
羁	ky,ki
兩	lạng,lưỡng,lượng
尗	thúc
江	giang
斠	các,dác,giác
軑	đại,đệ
辈	bối
忉	đao
涝	lão,lạo,lao
椷	ham,giam,hàm
隰	thấp
瑀	vũ
揳	kiết,tiết
實	chí,thật,thực
崌	cư
不	phu,bất,phi,phầu,bưu,phủ,bỉ
韁	cương
鳏	quan
褰	khiên,kiển
甂	biên,thiên
砨	ải
岛	đảo
殭	cương,thương
湍	thoan
辩	biện
蕾	lôi,lội
僨	phẫn
杓	tiêu,chước,thược
薉	uế
姬	cơ
韶	thiều
閱	duyệt
侬	nùng,nông
濬	tuấn
厄	ách,ngỏa
轲	kha
饼	bính
疭	túng
遞	đãi,đái,đệ
技	kĩ,kỹ
赳	củ
冪	mạc,mịch
鷀	tư,từ
猁	lị,lợi
伇	dịch
阹	khư
讔	ẩn
纙	la
旪	hiệp
襛	nùng,nông
沚	chỉ
圣	thánh,khốt
錯	thố,thác
膀	bàng,báng,bảng
綆	cảnh,bính
侜	chu,trưu
畂	điền,mẫu
桉	án,an
泳	vịnh
撾	qua
戇	cống,tráng
鳶	diên
遻	ngạc,ngộ
宁	ninh,trữ
仂	lặc
傞	ta,thoa
峘	hoàn
甑	tặng,tắng
黔	kiềm
馮	phùng,bằng
寁	tiệp,toản
腜	môi
敦	đối,đạo,độn,điêu,đôi,đôn,đoàn,đồn
予	dữ,dư
筱	tiểu
匾	biền,biển
駃	khoái,quyết
庁	thính,sảnh
者	giả
詳	tường,dương
辎	truy,tri
戹	ách
骜	ngạo,ngao
諰	tải,tai,tỷ
軨	linh
掭	thiệm
僂	lũ,lâu
廡	vũ,vu
磕	khái
卽	tức
万	mặc,vạn
扪	môn
憣	phiên
嶷	nghi,ngực
藷	thự
雪	tuyết
惇	đôn
篙	cao
蛑	mâu
芡	khiếm
蓥	oánh
鞸	bí,tất
鬂	mấn,tấn
仓	thảng,thương,xương
轇	giao
瑩	oánh
鶩	vụ
軶	ách
栈	chăn,sạn,trăn,xiễn
筷	khoái
浊	trọc,trạc
祘	toán
编	biên
鄈	qùy
誋	kị,kỵ
债	trái
腆	điến,thiển
炔	quế,khuyết
嶰	giải
瘍	dương
譜	phả,phổ
捅	thống
疠	lệ
傾	khuynh
灣	loan
噥	nông
渭	vị
葚	nhẫm,thầm,thấm,thậm
兙	thập khắc
烃	hĩnh,thinh
酊	đính,đinh
鑰	dược,thược
璗	đãng
蟑	chương
栗	lật
宣	tuyên
稀	hy,hi
燾	đảo,đào
毻	thóa
曺	tào
箇	cá
橢	đọa,thỏa
灇	tung
谼	hồng
祛	khư
湛	thầm,đam,trạm,tiêm,trầm
证	chứng
泪	lệ
銓	thuyên
舓	thị,thỉ,để,chỉ
鵜	đề
乚	hào,ất
擔	đam,đảm
窿	long,lung
逞	sính
篔	vân
鷤	đề,đàn
簆	khấu
搜	tiêu,sưu,sảo
託	thác
颌	cáp,hạp
総	tổng
異	di,dị
髩	mấn,tấn
烂	lạn
輞	võng
聆	linh
棹	trạo,trác
充	sung
儅	đáng,đương,đang
矿	quáng,khoáng
窶	lũ,cũ
礴	bạc
蹋	tháp,đạp
臚	phu,lư,lô
甏	bạng,bảnh
趪	hoàng
龥	dụ
抪	phô
椔	chuy
怫	phất,phí,phật,bội
穮	tiêu
洪	hồng
烽	phong
磌	điền
懾	nhiếp
嶍	tập
钒	phàm
妳	nễ,nãi
交	giao
蹉	sa,tha
锰	mạnh,mãnh
挽	vãn
街	nhai
廓	khuếch,khoác
狐	hồ
瀉	tạ,tả
尲	dam,giam
錧	quản
婟	hộ
鍼	kiềm,trâm,châm
灕	ly,li
膋	doanh,liêu
拫	ngân
螕	bế
絎	hạnh,hàng
噗	phốc,phác
玷	điếm
罢	bì,bãi
醡	trá
謚	thụy,ích,tự
篋	khiếp
綺	khỉ,ỷ
嚬	tần
脕	vạn
糴	địch
兇	hung
鋖	thỏa,tư
阫	bồi,phôi
遍	biến
挼	nhoa,noa
钻	toàn,toản
陘	hình,kính
熅	úy,uấn,uân
耖	sao,sáo
抬	sĩ,si,đài
闓	khải,khai
戶	hộ
馱	đạ,đà
氷	băng
嵌	khảm,khâm
喎	oa,oai
萜	thiếp
蓑	thoa,tuy,tai,soa,toa,xoa
詑	tha,di
螣	đặc,đằng
殙	hôn
款	khoản
斶	xúc
諓	tiễn
溓	liệm,liêm,niêm,liễm
惄	nịch
耽	đam
翃	hoằng,hồng,hoành
豷	ế
捻	niêm,niệm,niễn,niệp,nhiên,nẫm
鳇	hoàng
迺	nãi
鼻	tị,tỵ,tì
欱	hát,hạp
庆	khánh,khương,khanh
牿	cốc,cố
铠	khải
篩	sư,si
綿	miên
礤	sát
璪	tảo
易	dịch,dị
瑁	mội,mạo
轃	trân
禗	tư
揆	qũy
鸻	hằng
軒	hiên,hiến
际	tế
扶	phù,bồ
皞	hạo
癍	ban
連	liên,liễn
貲	tý,ty,ti
纬	vĩ
牝	bẫn,tẫn
鈾	do,trụ
诂	hỗ,cổ
膚	phu
盠	lễ
泷	lung,lang
麇	khổn,quân,quần,khuân
圈	khuyên,quyển
縞	cảo
踥	thiếp
焠	thối,tụy
嘜	mã,mạch,mạ
呾	đán,thát,đát
颙	ngung
抮	chẩn,hiển
几	kì,ỷ,cơ,ky,ki,kỷ,kỉ
呿	khư
慑	nhiếp
梴	siên
猗	y,uy,ỷ,ả
缞	thôi
近	ký,cấn,cận
繃	băng,bắng,banh
丵	trác
洽	hiệp,hợp
源	nguyên
蟏	tiêu
膉	ích
磴	đặng
阢	ngột
昏	hôn,mẫn
亶	thiện,chiên,đàn,đản
炀	dượng,dương
敘	tự
耔	tỉ,tỷ,tì,tỳ
韞	ôn,uẩn
宛	uyển,uyên
跀	ngột
忸	nục,nữu
猑	côn
悵	trướng
垝	qụy,qủy
參	xam,sâm,tam,tảm,tham
晢	triết
戡	kham
漯	tháp,loa
緜	miên
錶	biểu
氓	manh
皋	hao,cao
襄	tương
簸	bá
虘	ta
訕	san,sán
钴	cổ
泂	huýnh,quýnh
奏	thấu,tấu
骔	tông
氂	mao,ly,li
梦	mộng,mông
胘	huyền
宫	cung
泡	pháo,bào,phao
齘	giới
瀠	oanh,uynh
溦	vy,vi
佇	trữ
嚥	yên,yến,yết
碇	đĩnh,đính
攘	nhượng,nhương,nhưỡng
针	trâm,châm
渣	tra
轣	lịch
狰	tranh
漰	băng,phanh,bằng
钗	sai,thoa
茹	nhự,như
臉	thiểm,liệm,liễm,kiểm
跨	khóa
飆	tiêu,tiên
梭	thoa,toa
偏	thiên
珖	quang
鹑	thuần
箹	ước
醁	lục
佔	chiêm,chiếm
傛	dung
桃	đào
賕	cầu
椎	chuy,chùy,trùy
踟	trì
蚺	nhiêm
扛	công,cang,giang
謆	phiến
骳	bí,bị
呌	khiêu,khiếu
叉	xoa
荜	tất
躚	tiên
垦	khẩn
禀	lẫm,bẩm,bằng
閟	bí
貈	hạc,lạc,mạch
椠	thiễm,tạm
豖	súc
邱	khâu,khưu
遰	đệ,thệ
艩	tề
禂	đảo
顄	hạm,hàm
蠟	chá,lạp
螰	lộc
窩	oa
擴	khoác,khoách,khoáng,khuếch,khoắc
懹	nhượng,hoài
倒	đảo,đáo
懕	yêm
犩	nguy
擂	lôi,lụy
烫	năng,đãng,nãng
舂	thung
瀦	trư,chư
顫	thiên,đạn,chiến,đản
因	nhân
瓦	ngõa,ngóa
镦	đôn,đối
纑	lư,lô
掙	tranh,tránh
飉	liêu
璂	ky
桩	thung,trang
媰	trâu
𡈼	sính
膣	trất
邺	nghiệp
隋	đọa,tùy
蠂	nhiếp
研	nghiên,nghiễn
衯	phân
兰	lan
诨	hộn,ngộn
憢	hiêu
拳	quyền
稂	lang
還	hoàn,toàn
塈	ký,kỵ,kí
鼾	han,hãn
崱	trắc,tắc
賝	sâm
髒	tang,tảng,táng
籽	tử
篾	miệt,mịch,miết
巛	xuyên,khôn
淟	điến
醟	vinh
鳑	bàng
帶	đái,đới
鎏	lưu
囗	vy,vi
蹂	nhựu,nhu,nhụ
鑹	thoản
序	tự
慱	đoàn
鮞	nhi
葴	châm
穽	tỉnh,tịnh
庹	thỏa
鈎	câu
嘯	tiêu,sất,khiếu
鹽	diêm,diễm
鵫	trạo
伪	ngụy
瘣	khối,lỗi,hối
费	bỉ,phí,bí
雕	điêu
隽	tuyển,tuyến,tuấn
懺	sám
刃	nhận,nhẫn
輀	nhi
冨	phú
銍	trất,chí
陿	hiệp
𫩕	hoành
镠	liêu,lưu
靴	ngoa
蚩	xi,xuy,si
戄	cụ,quặc
销	tiêu
穤	noãn,nhu,nọa
妟	yến
衩	xái,sái
鸶	ty,tư
躋	tê,tễ
羋	mị,nhị,mễ
癉	đả,đan,đản
採	thái,thải
晾	lượng,cảnh
赞	tán
廑	cần,cận
傮	tao
攫	quắc,quặc
蝈	quắc
犋	cụ
夲	bổn,thao,bản
鋼	cương
娗	đĩnh
噭	kiêu,khiếu,tiếu
嗍	thoa
惑	hoặc
䮂	bạt
箚	tráp
禹	vũ
扢	hất,cột,ngật
赐	tứ
醷	ải,ức
垣	viên
屩	khiêu,cược
櫃	qũy,cử
灧	liễm,diễm
勾	cấu,câu
蒤	đồ
赇	cầu
窖	giáo,diếu,giếu
咩	mị
蛅	chiêm
𫝀	ngũ
每	môi,mai,mỗi
妇	phụ
蛛	thù,chu
炎	viêm,đàm,diễm
诽	phỉ
荊	kinh
鴰	hộc,cốc,quát
敎	giao,giáo
夋	xuân,thuân
暴	bạo,bão,bộc
彴	chước,bột
峥	tranh
瀹	dược,thược
鹘	cốt,hốt
龝	thu,thâu
咶	hoái,thị,quát,oa
塿	lũ,lâu
镩	thoản
夤	dần,di
邅	truyên,chiên,triển,triên
呥	nhiêm
輮	nhụ
腸	tràng,trường
矅	diệu
斗	đấu,ẩu,đẩu
騸	phiến,thiến,phiếu
庸	dong,dung
坯	khôi,phôi,bôi
饝	ma
廖	liêu,liệu
鞱	thao
渦	oa,qua
耵	đinh
霶	bàng
蓮	liên
跻	kiểu,tê,tễ,nghiêu
沒	một
蕳	gian
镃	tư
遶	nhiễu
橪	nhiễn
枝	kỳ,kì,chi
劃	hoạch
侹	thính,đĩnh,đỉnh
較	giáo,giảo,giếu,giác
淵	uyên
惝	thảng,sưởng
皈	quy
鎞	bề,tỳ,bế,phê
脏	tạng,tảng,táng
姊	tỷ,tỉ
剜	oan
鲞	tưởng
扃	quynh,côi,quýnh
崦	yêm
赙	phụ
疏	sơ,sớ
帞	mạch
罒	võng
栌	lô
砒	tì,phê,tỳ
瀺	sàm
啁	trào,chù,chu,trù,triêu
龔	cung
蠡	lễ,lãi,lê,lỏa
杕	đà,đệ
俾	tỷ,tỉ
瘳	liêu,sưu
攒	toàn,toản
匔	khung,cung
蛆	thư
釨	tử
姥	mụ,lão,lạo,mỗ
掗	nhã,á
紖	dẫn
跛	bả,bí
堀	quật
簇	thốc,thấu,tộc
撚	niển,niễn,niên,niết,niệm,niệp,nhiên
奓	xỉ,tra,trá,xa
璧	bích
寤	ngụ,ngộ
触	xúc
枕	chấm,chẩm
骟	phiến,phiếu
阈	vực,quắc
祆	hiên,yêu
蝝	duyên
辗	niễn,triển
旐	triệu
们	môn
痎	giai
獞	đồng
甋	đích
輼	ôn,uân
箓	lục
鞲	câu
蔌	tốc
𤕦	nanh
涮	xuyến
睪	đố,trạch,dịch,cao,nhiếp
疑	nghi,nghĩ,ngưng,ngật
櫟	dược,lịch,lao
矬	tọa,tòa,toa
濛	mông
搎	tôn
哕	uyết,uế,hối
噤	cấm
倞	lượng,kính
咼	quai,oai,oa,qua
铡	trát
炽	sí
功	công
捞	liệu,lao
柄	bính
拧	ninh
瀳	tiến
嚨	lung
风	phúng,phong,phóng
悔	hổi,hối
滬	hỗ
鼷	hề
齿	xỉ
臌	cổ
颱	thai,di,đài
訬	sao,miểu
蝌	khoa
誇	khoa,khỏa
迆	di,dĩ
卡	sá,ca,tạp,khải
诒	di
埱	thúc
敻	quýnh,huyến
畇	quân,vận
舖	phố,phô
耒	lỗi
騎	kị,kỵ
間	gián,gian,nhàn
笊	tráo,trảo
琎	tấn
嘵	hiêu
鰦	tư
彖	thoán
𢹍	hy
较	giảo,giếu,giác
舢	san
吕	lữ,lã
婿	tế
骑	kị,kỵ
涕	di,thế
廠	xưởng
磍	hạt
媦	vị
糇	hầu
暸	liêu,liệu
呢	ni,nỉ
謟	thao
撝	huy
栊	long,lung
枋	phương,bính
盈	doanh
搏	chuyên,bác,đoàn
紩	trật
鹝	nghịch
陴	bì,bài,tỳ
朆	phân
遗	di,dị
欿	khảm
蝿	dăng
树	thụ,thọ
嶅	ngao
巡	duyên,tuần
鱈	tuyết
镜	cảnh,kính
渚	hử,chử
銶	cầu
钋	bộc
轗	khảm
廈	hạ
昜	dương
咫	chỉ
缕	lũ,lâu
稰	tự
继	kế
疐	chí,trí,đế
騹	kỳ
燴	khoái,quái
憹	não,nông
锖	thương
鋭	duệ,nhuệ,đoái
陒	qụy
囝	kiển,nam,nguyệt,cưỡng,niếp,niên,nga,tể
鷰	yến
鲅	bát,phệ
葅	thư
譭	hủy
淠	tụy,bí,bái
骰	đầu
繰	tao,tảo,sào
扭	nữu
瓌	hoàn,côi,khôi
宕	đãng
觿	huê
埻	chuẩn,chuân
駈	khu
薙	trĩ,thế
硿	không
撷	hiệt
豜	kiên
佪	hồi
綍	phất
艿	nhứng,nãi
耰	ưu
含	hàm,hám
啻	thỉ,sí,thí,xí
沕	mật,vật
紡	phưởng
斸	chước,trọc,trục
極	cực
屄	tỳ,bì,bi
謞	hiêu,hào,hác,hao
殿	đán,điến,điện
蚑	kỳ,kì
蕮	tích
莨	lương,lang
螲	trất,điệt
扠	tra,sa,xoa
畢	tất
楂	tra,sa
幅	bức,phúc
甄	chấn,chân
踁	hĩnh
琇	tú
屐	kịch
豸	trại,trĩ,trãi
奶	nãi
眩	huyễn
復	phục,phúc,phú
泸	lư,lô
枒	nhạ,nha
酚	phân
挋	chấn
版	bản
帩	tiêu,tiếu
靋	lịch
胱	quang
灯	đinh,đăng
綂	thống
炅	quế,qúy,quýnh
拢	long,lũng
狓	phi
惜	tích
菑	chuy,truy,tai,tư,trí,trại,tri
陀	đà
璟	kỉnh,cảnh
颭	chiểm,triển
廨	giới,giải
鼸	khiểm
飅	lưu
熯	hán,nạn,nhiễn,hãn
徉	dương
僓	thối,đôi
噏	hấp
炸	trác,tạc
圻	kỳ,kì,ngân
鴢	ấu
导	đạo
飡	tôn,xan
煊	huyên
肉	nhụ,nhục,nậu
粿	qủa
搋	sai,trỉ,sỉ
擖	ca,khát
措	thố,trách
犒	khao
苫	thiệm,thiêm
襵	triệp
贫	bần
碐	lăng
𥰭	si
浪	lãng,lang
蹙	xúc,túc
凋	điêu
躤	tạ
櫬	quán,thấn,sấn
帄	đinh
佶	cát
打	đả,tá
移	xỉ,sỉ,di,dị
諟	thị,đế
肎	khẳng
姡	quát
潭	tầm,đàm
粪	phân,phẩn,phấn
庲	lai
袅	diểu,niễu,niểu,niệu
支	chi
瀲	liễm
痠	toan
文	vấn,văn
嚁	địch
早	tảo
辒	ôn,uân
启	khởi,khể,khải
聏	nục,nhi
鮿	triếp
決	huyết,quyết,khuyết
殟	ốt
憰	quất,quyệt
瀎	mạt
餙	sức
鬖	sam,tam
荩	tẫn
麴	khúc
亏	khuy,vu
抎	vẫn
菰	cô
羛	nghĩa
鸩	chậm,trậm
扒	bát,bái
衜	đạo
剀	cai,khải,cái
驵	tổ,tảng
纶	quan,luân
凂	mỗi,miễn
蚗	quyết
跾	thúc
鴂	quyết,quých
亘	hoàn,cắng,tuyên
婹	yêu
厥	quyết
滙	hối
莎	ta,sa,toa
償	thường
靆	đãi
礦	quáng,khoáng
剕	phí,phỉ
廙	dực,dị
腔	khoang,khang,xoang,soang
齰	sạ,trách
菅	gian
機	cơ,ki,ky
枅	kiên,phanh,bình,kê
簢	mẫn
轞	hạm
岽	đông,đống
帥	soái,súy,suất
影	ảnh
亙	cắng
涬	trĩ,hãnh
箾	tiêu,sóc,sao
濡	nhuyên,nhu,nhi
吶	niệt,nột
鞑	thát
磅	bàng,bảng
歾	vẫn,một
佐	tá
厘	triền,ly,li,hi
玨	giác
蘺	ly,li
屨	lũ
鈶	tỷ
珆	di
卫	vệ
嵑	kiệt
獑	sàm
蟁	văn
躠	tiết
汕	san,sán
洿	hộ,ô
缦	mạn,man
黜	truất
擲	trịch
佰	bách,mạch
荅	tháp,đáp
铤	thính,đĩnh
房	bàng,phòng
铫	điêu,điệu,điều,diêu
瞿	cụ,cù,củ
聤	đình
町	đỉnh,đinh
餈	tư
訃	phó
餂	thiểm,điềm
齭	sở
繖	tản
羹	canh,lang
猣	tông
宵	tiêu
捽	tốt
吗	ma,mạ
炯	huỳnh,quýnh
韘	thiếp,nhiếp
釕	liễu,niểu
挨	ải,ai
呆	ngai,ngốc,bảo
筸	can,cao
酈	lịch,ly,li
刺	thích,thứ
擣	đảo
摵	súc,sách
挩	thoát,thuế
腷	phức
蔆	lăng
靲	cầm
曡	điệp
圛	dịch
蚧	giới
繀	tối
蠐	tề
羿	nghệ
省	tỉnh,sảnh,tiển
虾	hà
隆	long
餵	ủy
狌	tinh,tính,sinh
纊	khoáng
栭	nhi
鹸	dảm,kiềm,thiêm
庿	miếu
鱉	biết,miết
绦	thao
刊	san,khan
恝	kiết
龋	khủ,củ
佴	nại,nhị
转	chuyển,chuyến
撌	qũy
蓇	cốt
謪	trích
射	xạ,dạ,dịch
蕈	khuẩn,tẩm,nấm
薛	tiết
繄	ê,ế
厝	thố,thác
樂	nhạo,lạc,nhạc
虛	khư,hư
童	đồng
珧	dao,diêu
慬	cần,cận
鬡	nanh,ninh
堞	điệp
誷	võng
匆	thông
鲽	điệp
砺	lệ
衼	chi
埘	thì
睒	thiểm
彻	triệt
頮	hối
浩	hạo
羶	chiên,thiên
纚	ly,sủy,sỉ,li,sái,lý
偪	bức,phúc
漚	ẩu,âu
姁	hú,hủ,hu
処	xứ,xử
櫽	ổn,ẩn
铅	duyên,diên
櫑	lôi,lũy,lỗi
儽	luy
鬚	tu
湅	luyện
讦	yết,kiết
汴	biện
撠	kích
襗	trạch
媭	tu
垕	hậu
鸣	minh
幛	chướng,trướng
珏	giác
难	nan,nạn
臿	tháp,áp,sáp,tráp
鬴	phũ,phủ
踹	đoán,sủy,soại
筏	phạt,phiệt
錾	trạm,tạm
籀	trứu
蠽	tiệt
弃	khí
涫	quan,quản
帔	bí,ấp
鎍	tác
熙	hy,hi
頗	pha,phả
癟	biết,tất,biệt,miết
筡	đồ
軋	ca,yết,loát
讪	san,sán
鼝	uyên
腿	thoái,thối
邐	lị,lệ
湋	vy
趫	nghiêu,kiều
詶	thù,chú
楩	tiện
賣	mại
橇	khiêu,tuyệt
稇	khổn
鳍	kỳ,kì
骀	đãi,đài
虭	điêu
並	tịnh,tính,bính
嬭	nễ,nãi
鄬	vy
鶖	thu
沍	hồ,hộ,hỗ
鞉	đào
殘	tàn
冇	mão
徛	khi
顁	đính
赱	tẩu
退	thối,thoái
毖	bí
坪	bình
裺	am,yểm
誊	đằng
禦	ngữ,ngự
痈	ung
泑	u,ửu
濺	tiễn,tiên
铺	phố,phô
焮	hân
湧	dũng
砖	chuyên
插	sáp,tháp,tráp
仱	kinh,kiền,căng
鮧	di
匄	cái
刷	xoát,loát
鉑	bạch,bạc
剋	khắc
瞩	chúc
鍾	chung
媞	thị
谌	thầm,kham
糌	ta
迻	di
沐	mộc
躥	thoan
緤	tiết
𬇹	quắc
娣	đệ,đễ
艽	giao,bông,cưu,cừu
极	kiệp,cực,cấp,cập
驟	sậu
餼	hy,khái,hi,hí,hý
溼	thấp
憙	hí,hý
屴	lực
墊	điếm,điệp
纀	bộc
炧	đả,tã
甘	cam
煒	vĩ
沇	duyện,duyễn
幞	phốc,phác
蜂	phong
骃	nhân
腱	kiên,kiện
騫	khiên,kiển
蔾	lê
楢	do,du
愮	dao,diệu
惎	kị,kỵ
睞	lãi,lai
歺	ngạt
纏	triền
釖	đao
傋	cấu
龟	quy,quân,khưu,cưu
觍	điến,điển,điễn
朹	cựu,cưu
称	xứng,xưng
荂	hoa
泐	lặc
慄	lật
嶄	tiệm,sàm
錡	ky,kĩ,ki,kỹ
腑	phủ
鞿	ky,ki
啞	nhạ,ách,á,a,nha
攄	sư
鶻	cốt,hoạt
嗽	thấu,tốc
繒	tăng
绔	khố
堍	thố,thỏ,miễn
脺	tụy
刍	sô
睁	tranh,tĩnh
濇	sáp,sắc,sắt
埸	dịch
尢	ngột,uông
舛	suyễn,xuyễn
侔	mâu
仟	thiên
歗	tiêu,khiếu
吁	dụ,hủ,hu
攮	nãng
㴫	cổn,quận
纡	u,vu,hu
桔	cát,quất,kiết,kết
桠	nha
錭	điêu
洊	tiến
墍	ký,kí
蠺	tằm,tàm
泞	nính,trữ
杪	diểu,miểu
衔	hàm
粒	lạp
唰	lạt,loát
钪	kháng
帀	tạp,táp
郜	cáo
茸	nhung,nhũng,nhĩ
剝	bác,phốc
俦	thù,trù
糯	nhu,nọa
瑒	đãng,sướng
膴	hô,vũ
煬	dạng,dượng,dương
嬐	ngẫm,tiêm
滵	mật
嚭	bĩ,phỉ,dĩ
瞻	chiêm
鮏	tinh
嚙	giảo,khiết,ngão
淰	thiểm,niệm,thẩm
诐	bí
秌	thu
丛	tùng
毸	tồi
驒	đàn
嚌	giai,tế,tễ
栋	đống
蕎	kiều
偌	nhạ,nhược
穡	sắc
槟	tân
鷦	tiêu
醞	ôn,uẩn,ổn,uấn
琣	bổng,bội
淜	băng,phanh
纺	phưởng
呼	hô,hao,há
踏	đạp
峺	canh
羜	trữ
趵	bác,báo
圕	đồ,thoan,đồ thư quán
釷	thổ
咯	khạc,cách,lạc,khách
堇	cận
準	chuyết,chuẩn
橋	kiều,kiểu,khiêu,kiếu,cao
撺	thoán,soán
瓯	âu
士	sĩ
叇	đãi
厅	thính,sảnh
菔	bặc
饇	ốc,ứ
柶	tê,tứ
簷	thiềm,diêm
犣	liệp
讀	đậu,độc
輫	bài
咈	phất,phật
媅	đam
魋	đồi
棉	miên
驱	khu
萲	huyên
皎	kiểu,hạo,hiệu
槱	dữu,dửu
藛	tả
氐	đê,chi,để
儍	sỏa,xọa,sọa
凫	phù
貌	mạc,mộc,mạo
鰜	kiêm
聱	ngao
謡	dao
彈	đàn,đạn
曠	khoáng
薸	phiêu
遘	cấu
杅	vu
矚	chúc
剿	tiễu
攽	bân,ban
竚	trữ
噅	huy,khuy
棵	khỏa,khõa
胪	lư,lô
晧	hạo
爇	nhiệt
筤	lang
檦	biểu
廬	lữ,lư
兮	a,hề
鳴	ô,minh
攛	thoán,soán
鴒	linh
朣	đồng
躳	cung
鯉	lí,lý
蘇	tố,tô
鎣	oánh
浭	canh
荷	hạ,hà
猥	úy,ổi
魑	ly,si
陇	lũng
狠	ngận,ngoan
觡	cách
爱	ái
與	dữ,dự,dư
锕	a
促	xúc
蝙	biên,biển
礊	khách
蟫	tầm,dâm,đàm
呭	duệ
騀	ngã
媺	mĩ,mỹ
菵	võng
柳	liễu
嫕	ế
蟙	chức
椐	cư,cử
誱	tiệp
渤	bột
灸	cứu
垢	cấu
袈	già,ca,cà
钉	đính,đinh
弰	sao
梢	sao,tiêu
蒭	sô
绐	đãi
迤	di,dĩ
拘	câu,cù
俅	cầu,cừu
逿	đãng,đường
郱	bình,cảnh
羆	bi
洗	tẩy,tiển
惱	não
慲	man
请	tính,thỉnh
爗	diệp
襃	bao,bầu,bậu
垃	lập,lạp
餳	đường,dương
麺	miến
绗	hàng
珿	súc,sước
憚	đát,đạn
剐	qủa
柙	hiệp,giáp
瘭	tiêu,phiếu,phiêu,tiếu
懩	dưỡng
悭	san,khan
鶚	ngạc
藪	tẩu
懱	miệt,miết
芋	dụ,vu,hu
鉛	duyên,diên
墅	dã,thự
倭	uy,oải,oa,nụy
氺	thủy
骅	hoa
玑	ky,ki
僖	hy,hi
蜎	quyến,quyên
羟	khan
霛	linh
齣	sích,xích,xuất
腕	oản,uyển
湁	sấp
彊	cưỡng,cương,cường
恨	hận
螉	ông
烧	thiêu,thiếu
啮	khiết,niết,ngão
憃	xuẩn,thung
齦	khẩn,ngân
彙	vựng,vị
瓚	toản
煨	ôi,ổi
慆	thao
龙	long,sủng,lũng
撢	thám,đạn
煥	hoán
骠	phiếu,phiêu
漶	hoán
吊	điếu
悴	tụy
橤	nhụy,nhị
騲	thảo
渹	oanh,sảnh,hoành
椁	quách
據	cứ
乁	di
飒	táp
驔	đàm
熛	tiêu,phiêu
骦	sương
衠	chuân
鏽	tú
歩	bộ
応	ưng
勁	kình,kính
躝	lạn
敏	mẫn
俜	binh,sính
橑	liêu
能	năng,nại,nai
匰	đan,đơn
埙	huân
嶲	tây
瀝	lịch
蝹	uân
阸	ách,ải
讞	nghiễn,nghiện
鉀	giáp
恤	tuất
蟕	chủy
欚	lễ
叟	sưu,tẩu
蒉	qũy,khoái
帰	quy
挓	trát
嘆	thán
娆	nhiêu,liểu,nhiễu
羰	thang
蚕	tằm,tàm
担	đam,đảm,đãn
臐	huân
曁	kị,kỵ
羲	hy,hi
困	khốn
佯	dương
颼	sâu,sưu
箷	di
拿	nã
谈	đàm
遴	lân,lấn,lận
抒	trữ
杶	suân,chuân
勵	lệ
躊	trù
諅	kỵ
妎	hái
乹	càn,can,kiền
犖	lạc,lao
𪡀	khiêu,kiệu,kiều
褎	tụ,dữu,hựu
蟒	mãng,mãnh
魈	tiêu
锱	tri,truy
狖	dứu
嘸	mô,phủ
齤	quyền
訦	thầm
则	tắc
长	trướng,trưởng,tràng,trường
朞	ky,ki,cơ,kỳ
蝦	hà
晉	tấn
撑	sanh,xanh
涎	duyên,diên,tiên,diện
濱	tân
膵	tụy
荏	nhẫm
毓	dục
咍	hai,hải
儔	thù,trù
駫	quynh
槭	sắc,túc
螭	ly,li
鎚	đôi,trùy,chùy,chúy
鹚	tư,từ
拍	phách,bác
鼥	bạt
篣	bàng,bành
氩	á
寓	ngụ
䄷	thạch
遝	đạp
裡	lí,lý
観	quan,quán
鷼	nhàn
粛	túc
镝	đích
褝	đan,đơn
厂	hán,xưởng
饴	di,tự
綮	khính,khể
牖	dữu,dũ
渰	yểm,yêm
袢	phán,phiền
銜	hàm
貂	điêu
硒	tây
视	thị
芞	khất
鄺	quảng
㞢	chi
錳	mạnh,mãnh
疎	sơ,sớ
蒨	thiến
爰	viên
卯	mão,mẹo
讆	vệ,ngụy
裟	sa
𡖉	côn
桎	trất,chất
雎	sư,thư
灨	công,cám
等	đẳng
繧	văn
瘘	lũ,lu
餲	át,ái,ế
鴝	cù
厌	yếm,áp,yêm,ấp
桢	trinh
䇲	sách,giáp
誂	điếu,điệu
蝆	dạng
杉	am,sam
鞢	tiếp
鲁	lỗ
彶	cấp
屏	phanh,bình,bính
臧	tàng,tang,táng,tàng tạng
龉	ngữ
娌	lí,lý
叠	điệp
啾	thu,tưu
戋	tàn,tiên
犼	hống
喋	điệp
鮐	thai,di
玉	ngọc,túc
塠	đôi
鹫	thứu
踪	tung
膨	bành
奠	điện
鍖	châm,sẩm
鱔	thiện
圔	áp
菡	hạm,hàm
遣	khiển,khán
侁	sân,thân,tân
洲	châu
丿	triệt,thiên,phiệt
濊	hoát,khoát,uế
葄	tộ
鹏	bằng
狸	uất,ly,li
尽	tần,tẫn,tận
錇	bậu,bồi
鐵	thiết
撣	đàn,đạn,đãn
胄	trụ
搒	bàng,bành,bang,bảng
儎	tải,tái
节	tiệt,tiết
旮	ca
楘	mộc
贽	chí,chuế
垠	ngân,ngần
雺	vụ
曷	át,hạt
紈	hoàn
噛	giảo
碾	chiển,niển,triển,niễn
腹	phúc
贷	thắc,thải
毳	thúy,thuế
票	tiêu,phiếu,phiêu
纵	túng,tổng,tung,tông
𦒧	hoạch
鈸	bạt,bát
佋	chiêu,thiệu
缨	anh
奨	tưởng
魚	ngư
瘕	hà,gia
塲	tràng,trường
绒	nhung
謌	ca
莘	tân,sân,sằn
溟	minh
頌	tụng,dung
韩	hàn
斋	trai
薰	huân
展	triển
諞	biển
荀	tuân
袼	các
斒	ban
聶	triệp,chiệp,niếp,nhiếp
哥	ca
軄	chức
骂	mạ
鋦	cúc,cư,cục
觋	hích
蝥	mao,mâu,miêu
拉	lạp
鍉	đề,đích,thi
嚫	sân,sấn
崿	ngạc
氆	phổ,bảng
甡	sân
孳	tư
个	cá,cán
鞟	khuếch,khoác,khoách
呜	ô
嫖	phiêu,biều
霝	linh
袥	thác
欃	sàm
郈	hậu
踼	thảng,thang
簿	bộ,bạc,bạ
羬	hàm
鋪	phố,phô
征	chinh,trưng
飄	phiêu
懽	hoạn,hoan,hoàn,quán
鏈	liên
蝻	nam
届	giới
帅	soái,súy,suất
麚	xạ,gia
椴	đoạn
屠	đồ,chư
演	diễn
杚	cật
颤	chiến,đản
碩	thạc
犢	độc
惛	muộn,hôn
隁	yển
鬻	dục,chúc
癲	điên
悗	muộn,man,miễn
媪	ảo
螞	mã
窐	khuê
匮	qũy
旓	sao
岘	hiện,nghiễn
潼	đồng
蛎	lệ
萃	tụy,túy,thúy
炕	kháng
薧	hao,hảo,khảo
貞	trinh
撓	nạo
胻	hành
娉	phinh,sính
陫	phỉ,phi
櫺	linh
獝	huất,húc
躒	lịch,lạc
鉒	trú
筳	đình
讼	tụng
綜	tống,tổng,tông
芃	bồng,ngải
泌	bí
锗	giả
擄	lỗ
鍡	úy
刬	sản,sạn
矉	tần
崟	dần,ngâm
佛	phất,bột,bật,phật
酐	can,hãn
傱	tủng
飨	hưởng
鏾	tán,tiển
羃	mạc,mịch
伅	độn,đồn
椒	tiêu
孃	nương
慪	âu
刽	khoái,quái
聚	tụ
梮	cục
暗	ám,âm
衊	miệt
验	nghiệm
閬	lãng,lang
阼	tạc,tộ
禼	tiết
嗋	hiệp
彲	li,si
丫	a,nha
骆	lạc
镘	man
鄖	vân
藃	háo
涛	đào
国	quốc
砏	phàn
釹	nục
呂	lã,lữ
钢	cương
闒	tháp,đạp
殷	yên,an,ân,ẩn
鬈	quyền
澌	ty,tê,tư,ti
鷞	sương,sảng
蓨	tu,điệu,điều
髇	hao
餓	ngã,ngạ
礨	lôi,lỗi
妩	vũ
乓	bàng,bang
她	tha,tả
貢	cống
颎	huỳnh,quýnh
鳧	phù
牠	đà,tha
臢	trâm,châm
譏	ky,kỵ,cơ,ki
郤	khích,khước
鰧	đằng
襫	thích
覃	đàm,diễm
辟	thí,tịch,tích,tỵ,phích,bễ,bách
岍	khiên
裓	giới,cức,cách
南	na,nam
埯	am
䓖	cùng
吏	lại
釩	phiếm,phạm,phàm
黼	phủ
锡	tích
谿	hoát,hề,khê
旍	tinh
聖	thánh
揭	khế,yết
餞	tiễn
蓁	trân,trăn
駡	mạ
跟	cân,ngân,căn
鼲	hồn,côn
袤	mậu
獭	thát
添	thiêm
犗	giới
症	trưng,chứng
潀	tùng,tung
轵	chỉ
鼂	triêu,triều,trào
扯	xả
攖	oanh,anh
甇	trứu,anh
犝	đồng
鍭	hầu
蛾	nghĩ,nga
纪	kỉ,kỷ
鮀	đà
關	quan,loan
朊	oản,nguyễn
疵	tì,tỳ
鸿	hồng
共	cộng,củng,cung
侂	thác
驷	tứ
磼	tập
吭	hàng,khang,hạng
稹	chân,chẩn
簠	phủ
驾	giá
郑	trịnh
绢	quyên
疘	cương,giang,xoang
歟	dư
唅	ham,hàm,hám
贿	hối
狲	tôn
谞	tư
繁	bàn,bà,phiền,phồn
襮	bộc
羨	tiễn,tiện,diên
瓤	nhương
麃	tiêu,phiếu,bào,biều
訛	ngoa
抶	sất
𣈱	sướng
僳	túc
轔	lân,lận
拾	kiệp,thiệp,thập
膻	đán,chiên,thiên,đãn
醐	hồ
筍	tuận,tuẩn,duẩn,duẫn,tấn,tuân
鴐	gia
揷	tháp,tráp,sáp
纆	mặc
濕	sấp,thấp,chập
噎	ế
懊	úc,áo
黖	hý
袷	kiếp,khiếp,cáp,giáp
徼	kiểu,kiêu,yêu,kiếu
鱞	quan
嗗	oát
𦒜	yên
摺	triệp,chiệp,chiếp,lạp
祔	phụ
鑑	giám
簟	điệm
荥	huỳnh
劘	my,mi
摏	thung
尉	uất,úy
衿	câm,khâm
髆	bác
姣	giao,hào,giảo
伯	bá,bách
湌	xan
揂	do,thu,tù
杵	xử,chử
纟	mịch
輐	ngoạn
擗	bịch,bích,tịch,tích,phích
详	tường,dương
鐙	đặng,đăng
啗	đạm
宂	nhũng
蓍	thi
狄	thích,địch
窈	yểu
兵	binh
藗	tốc
笮	trá,tạc,trách
铛	sanh,đang
倝	cán
鬕	mạc
髭	tì,tư,tỳ
鹻	kiềm,giảm,thiêm,kiểm
傌	mã,mạ
镱	ý
郚	ngữ
儞	nhĩ,nễ
膷	hương
椽	chuyên,triện
慘	thảm
闚	khuy
潏	quyết,duật,quất,thuật
殊	thù
蚌	bạng
疬	lịch
酵	giáo,diếu
枻	duệ,tiết
謇	kiển
斩	trảm
淅	tích,tý,tí
桀	kiệt,kiết
唗	đẩu,đâu
气	khí,khất
膿	nung,nùng
惢	nhị,tỏa
潁	dĩnh,toánh
殱	tiêm
揃	tiễn,tiên
娭	hy,ai,hi
垼	dịch
垓	giai,cai
謭	tiễn
苹	biền,phanh,bình,tần
胀	trướng
佝	câu
蹅	tra,đạp
仙	tiên
坩	kham
鷺	lộ
昄	bản
蜚	phỉ,phi
顏	nhan
韜	thao,sáo
枨	tranh,trành
圃	phố
疰	chú
虖	hô
棖	tranh,trành
掄	luân
卼	qụy,ngột
垲	khải
戀	luyến
哂	sẩn
釿	ngận,cân,ngân
燁	diệp
勌	quyện,quyển
茉	mạt
抟	chuyên,đoàn
殫	đàn,đạn
椤	la
恸	đỗng,động
池	trì
褏	tụ,dữu,hựu
咮	trụ,chu
颊	giáp
氃	đồng
踩	thái,thải
雋	tuyển,tuyến,tuấn
讣	phó
黋	hoảng
獀	sưu
矎	huýnh,huyến
鼪	sinh
滕	đằng
酆	phong
吷	huyết,xuyết
嚼	tước
砃	đan
黚	kiềm
腢	ngẫu
睛	tình,tinh
鍛	đoạn,đoán,đoàn,thuyến
閕	nhạ,ha
颉	hiệt,giáp
单	thiện,đan,thiền,đơn
磢	sảng
禱	đảo
莋	tạc
鈔	sao,sào,sáo
鵩	phục
愾	hất,hy,khái,hi,khải
孱	sàn
硤	giáp,hạp
鈐	kiềm
搩	trách
靶	bả,bá
凔	sương,thương,sảng
衱	kiếp,kiệp
択	trạch
繳	kiểu,chước
釤	sán,sàm,sám,tiêm,sam
啟	khởi,khải
補	bổ
艺	nghệ
铊	tha
皻	tra,cha
辭	từ
闱	vy,vi
許	hử,hứa,hổ
菾	điềm
輕	khánh,khinh
㗖	đạm
塓	mịch
罿	đồng
冐	mạo
胳	các,ca,cách
顔	nhan
你	nhĩ,nễ
龤	hài
豩	bân
罍	lôi
嫿	hoạch,họa
佃	điền
訅	khao,cừu
引	dấn,dẫn
煩	phiền
蟄	trập,chập
岭	lãnh,linh,lĩnh
蘐	huyên
瀘	lư,lô
丳	sạn
琺	pháp
鐭	áo
箙	phục
祅	yêu
戣	qùy
彸	chung,công
欶	sóc
磧	thích
躂	thát,đáp
瘂	á
颜	nhan
蹁	biên,biển
媲	bễ,thí
堑	tiệm,tạm
赉	lãi,lại
袜	vạt,mạt,miệt
邰	thai
誉	dự
盲	vọng,manh
裊	diểu,niểu
御	nhạ,ngữ,ngự
敖	ngao,ngạo
蝁	ác
猀	sa
噹	đáng,đương,đang
乍	sạ,tác,xạ
瞅	thu,thiễu
楷	giai,khải
邋	lạp
暈	vựng,vận
宮	cung
妊	nhậm,nhâm
躐	liệp
艓	điệp
劲	kình,kính
鳥	điểu
嶴	áo
鐔	thiền,tầm,đàm
號	hạo,hào,hiệu
傍	bàng,bạng
镵	sàm
嗾	thốc,tẩu
桯	doanh,thinh
蟯	nhiêu
繷	nũng
胙	tộ,tạc
杞	kỉ,kỷ
拃	tra,tạt
达	đạt,thế
襱	lung,lũng
伺	tý,tí,tứ
诮	tiếu
緞	đoạn
喒	cha,ta,tàm,gia
鐦	khai
胥	tư
镔	tấn
禺	ngẫu,ngu,ngụ,ngung
爊	ngao,ao
掉	trạo,điệu
峰	phong
萋	thê
漊	lũ,lâu
賽	tái,trại
嵿	đính,đỉnh
礞	mông
芀	điêu
赴	phó
匽	yển
赅	cai
赸	san,sán
窒	trất,chất
虺	hôi,hủy
甩	súy,suất
欣	hân
钠	nạp,nột
勰	hiệp
絞	hào,giảo
䱌	di
翜	sáp
榧	phỉ
陌	mạch
诿	dụy,ủy
堆	đồi,đôi
妸	a
鬭	đấu
凷	khối
菼	thảm
闑	niết
掎	ky,kỉ,ỷ,kỷ
谱	phả,phổ
碟	điệp
镎	nã
埕	trình
晡	bô
唬	hạ,hách,hao,hổ,hào,quách
殶	chú
捐	quyên
矑	lô
鯧	xương
騞	hoạch,hạch
唭	khí,khi
瀣	giới,dới
鍰	hoàn
撽	khiếu
戧	sáng,sang,thương
縿	tiêu,sam
驢	lư
颠	điên
岮	đà
意	y,ý
郭	quách
紋	vấn,văn
滹	hô
鳌	ngao
敞	xưởng,sưởng
潑	bát
煺	thoái
鹄	hộc,cốc
薝	chiêm,đảm
翮	cách
泺	bạc,lạc
顈	quýnh
霉	my,môi,vy
離	lệ,ly,li
幗	quắc
雲	vân
崢	tranh
寡	qủa
苍	thưởng,thương
肫	truân,chuân,đồn,thuần
靤	bạo
莼	thuần
罏	lư,lô
挐	nạo,nã,nư,noa
嵠	khê
微	vy,vi
鄫	tằng,tăng
髌	tẫn,bận
繠	nhụy
馁	nỗi
雗	hàn
永	vịnh,vĩnh
橼	duyên
旝	quái
図	đồ
宄	qũy
厢	sương,tương
汜	dĩ,tỷ,tỉ
懵	mặng,mông,mộng,manh
鬃	tùng,tông
陽	dương
胝	đê,chi,tri
再	tái
丟	đâu
黃	hoàng,huỳnh
窪	oa
蚰	do,du
蔘	tam,sâm
貣	thắc
頄	cừu
揾	uấn
褾	biểu
摫	quy
剹	lục
蒂	đế
宨	điệu,tiao3
鸑	nhạc
宼	khấu
簧	hoàng
呰	tử
羭	du
鲣	kiên
侥	kiểu,nghiêu
耞	gia
芊	thiên
軵	nhung,nhũng
廞	hâm,hân
吳	ngô
障	chướng,chương
調	điệu,điều
驛	dịch
涪	phù
綁	bang,bảng
薶	mai
礜	dự,xác
鲇	niềm,niêm
迦	già,ca
潘	phan,bàn
塡	điền,trần,trấn,chấn,điễn
吅	tụng,huyên,tuyên
瑑	triện
櫨	lô
箖	lâm
燮	tiếp
醿	my
丏	cái,diễn,miễn
瑾	cẩn,cấn
籟	lãi,lại
硗	sao,khao,nghiêu
冶	dã
勞	lạo,lao
宾	thấn,tân
輜	tri,chuy,truy
踦	kì,khi,ỷ,cơ,kỷ,kỉ
娼	xướng
瞄	miêu,miểu
琵	tì,tỳ
鉈	xà,tha
漼	tồi,thôi
钆	ca
黯	ảm
猤	qúy,quảng
撇	phiết
眥	xải,tý,trại,tí
琥	hổ
狶	thỉ,hi
扑	phốc,phác
窻	song
酏	di
唫	ngâm,cẩm,cấm
尞	liêu
雰	phân
怨	uẩn,oán
冲	xung,trùng
旹	thời,thì
籒	trứu
梿	liên
睂	my,mi
糍	từ
弾	đàn,đạn
纗	huê
嫦	thường
铓	mang
優	ưu
无	vô,mô
頯	qũy,qùy
鍤	sáp,tráp
镭	lôi
甿	manh
奲	xả,đả
帙	trật,pho,dật
饲	tự
爵	tước
䙷	đức
铈	thị
蛰	trập,chập
邊	biên
件	kiện
斃	tễ,tệ
蚲	bình
劖	thiền,sàm
綰	oản
胆	đàn,đảm
郃	cáp
俫	lại,lai
癗	lũy,lỗi
推	suy,thôi
掇	xuyết
畍	giới
諜	điệp
猲	cát,hiết,yết,hạt
黛	đại
磑	ngôi,cai,ngại
顼	húc
乞	khí,khất
墽	khao
还	toàn,hoàn
蜯	bạng
廼	nãi
凵	khảm
鞥	nhăng
尬	giới
寂	tịch
崗	cương
滚	cổn
咽	ân,yến,yết,ế,yên
髂	khách
籅	dư
阇	đồ,xà
唛	mạch,mạ
岚	lam
嗏	chà,trà
渌	lục
謍	hoanh,doanh
碣	kiệt,kệ
呷	hạp
堘	thăng
鳮	kê
芰	kị,kỵ
懅	cứ
穧	tế,tễ
襆	phộc,bộc
楥	huyên,tuyên,hoãn
皪	lịch
萆	tế,bế,tích,tì,bề,tý,tỳ
蒝	diêm
讥	ky,kỵ,cơ,ki
曹	tào
郰	trâu,châu
玍	ca
螢	huỳnh
詀	chiêm,điêm,siệp
腾	đằng
鷖	ê
穷	cùng
埮	đàn,đàm
銻	đễ
騻	sương,sảng
経	kinh
珊	san
锓	tẩm,tiêm
謨	mô
姚	dao,diêu
瓠	hoạch,hồ
賥	túy
忆	ức
鱀	ký
槵	hoạn
愽	bác
叭	bá
鹰	ưng
樓	lâu
搕	khạp,áp,ngạ,hạp
粃	bỉ,tỷ,chủy
盰	cán
剴	cái,cai,khải
椀	oản,uyển
饌	soạn,tuyển
噔	đăng
軍	quân
茳	giang
壾	mãng
沂	nghi,ngân
櫾	trục,dứu
胅	điệt
挍	hiệu
旞	toại,tùy
黤	yểm,yêm
种	chủng,chúng,xung,trùng
崫	quật
縗	thôi
偾	phẫn
鞹	khuếch,khoác,khoách
新	tân
蝄	võng
责	trái,trách
彠	hoạch
署	thự,thử
剪	tiễn
題	đề,đệ
儗	nghĩ
豔	diễm
綟	lệ
儐	tấn,tân
泊	phách,bạc
晝	trú
盌	oản,uyển
饛	mông
膽	đảm
衉	khách
飋	sắt
縷	lũ,lâu
韧	nhận
潸	san
層	tằng
茝	sải,chỉ
摲	sảm
黓	dặc
褚	trữ,trử
弛	thỉ
梔	chi
嚓	sát
瘠	tích
憀	liêu
陳	trận,trần
鷥	ty,tư
昔	tích,thố,tịch,thác
嶓	ba
螓	trăn,tần
菸	yên,ư
冔	hu
夌	lăng
黲	thảm
郠	cánh
熹	hy,hi
覯	cấu
托	thác
菇	cô
鯶	hỗn
韤	vạt,mạt,miệt
渴	kiệt,khát,hạt
朙	minh
斯	tư
曛	huân
抭	du
覛	mạch
跥	đọa
蹟	tích
掔	khan,kiên
歸	quy,qúy
煳	hồ
镄	phí
忕	thái,thệ
侮	vũ,hối
車	xa
鄅	vũ
嘗	thường
咸	hám,hàm,giảm
盹	truân,độn,chuân
詛	trở,trớ
饩	hy,khái,hi,hí,hý
郄	tức,khích,khước
蕿	huyên
欗	lan
焐	ngộ
櫡	trước
貓	miêu
铙	nạo,nao
殈	hức
厠	trắc,xí,lịch
娽	lộc
禖	môi
詣	nghệ
喷	phún,phôn
軫	chẩn
愈	dũ
涍	hiếu
譾	tiễn
曦	hy,hi
怱	thông
阬	kháng,khanh
蠋	thục,trục
梐	bệ
氻	lặc
蛔	hồi
橱	trù
畵	hoạch
迄	hất,ngật
燡	dịch
麜	lật
舅	cữu
艉	vĩ
搫	bà,bàn
趒	điêu
烩	khoái,quái
踱	đạc
辢	lạt
爻	hào
悱	phỉ
鲒	cát
蛺	hiệp,kiệp,giáp
僲	tiên
苕	điều,thiều
鬋	tiễn,tiên
酎	trửu,trữu
瞷	gián,gian,nhàn
痕	ngấn,ngân
雀	tước
灼	chước
張	trương,trướng
狞	nanh,ninh
罭	vực
阚	hám,khám,hảm,giảm
婘	quyến,quyền
嘡	thang
襢	triển,đản
慎	thận
篁	hoàng
妨	phương,phướng
棕	tông
劐	hoát
顾	cố
姞	cật
鰹	kiên
阱	tỉnh,tịnh
椹	thầm,châm,thậm,thẩm
緳	khiết
拌	phan,phán,bàn,bạn
壑	hác
労	lao
劒	kiếm
艧	hộ
逛	cuống
戏	huy,hi,hô,hí,hý
舳	trục
釦	khẩu,khấu
鷂	diêu,dao,diệu
煇	huy,huân,vận
芼	mao,mạo
唼	xiệp,thiếp,xiếp
飙	tiêu
勋	huân
渒	tụy
诅	trớ
寽	luật
鱟	hấu,hoành
介	giới
嚾	hoan
薖	khoa,oa,qua
覆	phúc,phú
壹	nhất
屿	tự
牕	song
扁	biên,thiên,biển
湄	my,mi
峙	trì,trĩ
集	tập
攎	lô,la
櫋	miên,biên
碕	kỳ
李	lí,lý
蜍	thừ
秜	ni
黴	môi,mi,my,vi,vy
蛳	sư,tư,si
铗	khiếp,kiệp,giáp
繚	liễu
襠	đương,đang
咎	cao,cữu
弑	thí
暌	khuê
闲	nhàn
鴕	đà
瞬	thuấn
沾	điếp,triêm,thiêm,tiêm
掁	trành
梧	ngô,ngộ
郔	diên
贉	đảm
騕	yểu
赋	phú
秖	kỳ,kì
窰	dao,diêu
湃	phái,vy,bái
鄭	trịnh
杭	hàng
蓖	bề,bế,tỳ
杗	mang
用	dụng
宽	khoan
浸	tẩm,thâm
瀨	lại
翡	phí,phỉ
鄂	ngạc
惊	kinh,lương
緇	tri,chuy,truy
髟	tiêu,sam,bưu
饉	cận
同	đồng
墝	sao,xao,khao,nghiêu
瘏	đồ
羯	yết,kiết
力	lực
藓	tiển
驉	hư
磨	má,ma
擉	thục,trạc
朝	triêu,triều,trào
簍	lũ,lâu
恳	khẩn
袕	huyệt
屚	lậu
榦	cán,hàn
鱵	châm
僡	huệ
俱	câu
琨	côn
莏	ta,sa
穀	cốc
榞	nguyên,yuan2
浺	xung
虷	can,hàn
硭	mang
鞺	thang
陑	nhi
爆	bạc,bạo,bộc
椘	sở
杘	sí
抹	mạt
莓	môi
佗	đà,tha
浬	lí,lý,hải lí
氇	lỗ
銬	khảo
闠	hội,hối
豨	hy,hi
儿	nhân,nhi
臕	tiêu,phiếu,phiêu
琩	xương
切	thiết,thế
苾	tất,bật
蘿	la
觤	qủy
嚵	sàm
叜	tẩu
屌	điểu,điếu
鬳	quyện
崽	tải,tể
潩	dị
槽	tào
疓	đinh,nãi
鹩	liêu
殜	triệp
蟜	kiểu
蒿	hao
侅	cai
嘽	siển,xiển,than
缴	chước,kiểu
摻	thám,sâm,sảm,tiêm,sam,tham
渳	nhị
覭	minh
獼	my,mi,di
臨	lậm,lâm,lấm
踖	tích
懆	thảo,tháo
鏑	đích
溴	xú,kích
歑	hô,hư
魘	yểm
蜽	lưỡng,lượng
看	khan,khán
釥	thiểu
订	đính
俸	bổng
嘌	phiêu
苢	dĩ
笤	điều
柞	sạ,tạc,trách
澉	cảm,cám
京	kinh,nguyên
燙	năng,đãng,nãng
貫	oan,quán
缳	hoàn,hoán
闫	diêm
琿	huy,hồn
鏨	trạm,tạm
艛	lâu
訥	nột
孌	luyến
橥	trư
荸	bột
湻	thuần
嵥	kiệt
虚	khư,hư
逅	cấu
瘻	lũ,lâu,lu
褸	lũ
炝	sang
峡	hiệp,hạp,giáp
域	vực
馈	qũy
栽	tải,tài
瓴	linh
襒	biết
嘛	ma
籩	biên
揣	chùy,sủy,đoàn,tuy
芳	phương
雖	vị,tuy
痌	thông,đồng
掮	kiên
壓	yểm,áp,yếp
筋	cân
浿	phái,phối,bái
慮	lự,lư,lục
峝	đỗng,động,đồng
辦	biện,bạn
淭	hoài
漾	dạng
豄	độc
舕	đạm
戴	đái,đới
怮	u
巧	xảo
榿	khi
兄	huống,huynh
劋	tiễu,giảo
眱	di
籔	sổ,tẩu
彑	kế,kệ
稬	noãn,nhu,nọa
丗	thế,táp
譳	nậu
膇	truy
碳	thán
睎	hy,hi
絯	ai
厩	cứu
愫	tố
犎	phong
僽	sậu
瓒	toản
坷	kha,khả
浦	phổ,phố
竣	thuyên,thuân
囘	hồi,hối
胃	trụ,vị
俠	hiệp
乆	cửu
拚	phiên,phanh,phan,biện,phấn
钔	môn
焉	yên,diên
緪	cắng,cánh,căng
柑	kiềm,cam
鮹	sao
杙	dặc,dực
骲	bão
娴	nhàn
屺	khỉ,dĩ
瘫	than
斪	cù
笱	cẩu,cầu,cú
缘	duyên
鴻	hồng
领	lãnh,lĩnh
姌	nhiêm
黬	ảm,cam
输	thú,thâu,du
鋣	da
瘃	trúc,chúc
薑	khương
襪	vạt,mạt,miệt
亚	á
馔	soạn
詭	qủy,ngụy
滫	tưu,tựu
澤	trạch,dịch,thích
芪	kỳ,kì
撆	biết
悽	thê
蚯	khâu,khưu
琹	cầm
浼	mỗi,miễn
嚧	lô
鼌	triều,trào
啚	đồ,bỉ
需	tu,nhuyễn,nhu,nọa
褮	huỳnh,anh
姷	hỗ
鲰	tưu
嘄	kiêu
猾	hoạt
骼	cách
测	trắc
嘣	băng
領	lãnh,lĩnh
縱	túng,tổng,tung,tông
鯯	chế
员	viên,vân
頫	thiếu,phủ
裠	quần
恃	thị
壸	khổn
璡	tấn
醊	chuyết
絮	trữ,nhứ
槧	thiễm,tiệm,tạm
倠	huy
惞	hân
貄	tứ
讅	thẩm
鰵	mẫn
厓	nhai
襶	đái,đích,đới
隱	ấn,ẩn
瓀	nhuyên,nhuyễn
釄	my,mi
鼆	manh
书	thư
檃	ổn
镖	tiêu,phiêu
馥	phục,phốc,phức
苑	uất,uẩn,uyển,uân
讬	thác
亸	đả
蘸	trám,tiếu
追	truy,đôi
鑱	sàm
镊	nhiếp
葰	tuấn
寀	thái
畮	mẫu
潰	hội
瘼	mạc
堨	nghiệt,ái,yết
沧	thương
谛	đề,đế
緼	ôn
浑	hồn,hỗn
坊	phường,phòng
開	khai
呺	hiêu,hào,hao
峾	ngân
感	cảm,hám
尺	xích,chỉ
习	tập
巘	nghiễn,hiến
阕	khuyết
惡	ác,ố,ô
甗	nghiễn
頲	thính,đĩnh
擡	sĩ,đài
煅	đoán
斿	du,lưu
廰	thính,sảnh
陛	bệ
麛	mễ,mê,my
溺	niệu,nịch
緶	biền
疔	đinh
亢	hàng,kháng,cương,cang
啎	ngộ,ngỗ
律	luật
尫	uông
嘒	huế,uế
箵	tỉnh
蓊	ông,ống
顽	ngoan
丰	phong
罡	cương,cang
磉	tảng
从	tụng,tùng,tung,túng,thung,tòng
踉	lương,lượng
嬤	mụ,ma,mạ
鹉	vũ
趬	khiêu
跕	điệt,thiếp
狂	cuồng
欧	ẩu,âu
廂	sương,tương
阏	át,yên
洵	tuân,tuần
銤	mễ
僸	cấm
撂	lược
黭	yểm
飪	nhẫm
笓	tỳ
果	qủa
鮸	miễn
煆	hạ,hà,đoán
摯	chí
铁	thiết
孚	phu
叨	thao,đao
爫	trảo
齥	tiết
霾	mại,mai
匜	di,dị
鴘	biển
傖	sanh,thảng
蹻	kiểu,nghiêu,cược,kiều
喩	dụ
计	kế,kê
餍	yếm
禿	thốc,ngốc
晕	vựng
櫚	lữ,lư
鲆	bình
栏	lan
谄	siểm
收	thu,thâu,thú
镗	thang
覬	ký,kí
鐃	nạo,nao
呏	thăng
萏	đạm
繆	cù,mục,mâu,mậu
諲	nhân
崔	tồi,thôi
癶	bát
敱	ngai
嚅	nhu
芜	vu
孿	luyến,loan,luyên
鉹	di
煔	tiêm
紕	bỉ,phi,bì
悾	không
韫	uẩn
蝜	phụ
逄	bàng
轊	duệ,vệ
崴	uy
陧	niết
幾	ký,kí,khởi,cơ,ky,kỳ,ki,kỷ,kỉ
肺	phế,bái
礡	bạc
囿	hữu,hựu
手	thủ
丘	khiêu,khâu
掴	quắc,quách,quốc,quặc
偈	khế,kệ
蚤	tảo
釾	da,nha
嚮	hưởng,hướng
掊	phẩu,bồi,bẫu,phó,phẫu
阺	để
英	anh
淑	thục
悝	lí,lý,khôi
錙	truy,chuy,tri
盘	bàn
侗	thông,đồng,động,thống
鵻	giai,chuy
夂	truy,tri
嗅	khứu
瘉	dũ
鑐	tu,nhu
鑘	lôi,lỗi
馹	nhật
鸲	cù
蜷	quyền
妞	nữu
螌	ban
諢	hộn,ngộn
樽	tôn
娬	phú,vũ
淺	thiển,tiên
贾	giả,giá,cổ
聻	tích,nễ,tiệm
棠	đường
骿	biền
齜	thử,sài
愔	am,âm
醵	cự
輠	khỏa,qủa
縪	tất
醋	thố,tạc
媄	mỹ
匴	toán
蛉	linh
蝃	chuyết,đế
艴	phất,phật
靦	điến,điển
刁	điêu
豏	hãm
齡	linh
鼖	phần
爣	thảng,lãng
嵹	cưỡng
坁	chì,chỉ
慁	hỗn
谐	hài
皮	bì
堤	đề,đê
蹓	lựu
鄶	cối,quái
鄃	du
蔠	chung
湮	yên,nhân
脸	thiểm,liễm,kiểm
瘛	khiết,xiết
跷	khiêu,nghiêu
于	ư,vu,hu
鲭	chinh,thinh
罘	phù,phầu
饢	năng,nang,hướng,nãng
寣	hốt
佊	bỉ
鈡	chung
蹺	khiêu,nghiêu
菣	khẩn
钌	liễu
甞	thường
邃	thúy
麗	lệ,ly
鲡	ly,li
鍬	thiêu
豣	kiên
輪	luân
闖	sấm
蚶	ham
鏹	cưỡng,cường
桂	quế
鸕	lô
剣	kiếm
徙	tỷ,tỉ
綷	túy,tối
艒	mục,mạo
条	thiêu,điêu,điều
勖	úc,húc
腧	thú
啀	nhai
咒	chú
轠	lôi
攥	toản,tát
眨	trát,tráp,triếp
抵	để,chỉ
孀	sương
醺	huân
儋	đam,đảm
菆	toàn,trâu,thoàn,tưu
呣	mô
鑾	loan
柏	bách,bá
審	thẩm
燕	yến,yên
凝	ngưng
磽	khiêu,khao,nghiêu,xao
忌	kị,ký,kỵ,kí
趯	dược,địch
毷	mạo,máo
頃	khuynh,khuể,khoảnh
郉	hình
藩	phan,phiên
饧	đường,dương
拋	phao
鑣	tiêu
慓	phiếu,phiêu
狨	nhung
辀	châu,chu
荨	kiền,tầm,đàm
賴	lại
嗻	gia,cha,già,chạ
匹	mộc,thất
鱧	lễ
殳	thù
綪	thiến,tranh
咵	khoa
飢	cơ,ky
径	kính
检	kiểm
鞧	thu
黇	chiêm
櫱	nghiệt
讖	sấm,sám
靂	lịch
賍	tang
茬	tra
翶	cao,ngao
通	thông
瞭	liễu,liêu,liệu
哿	cả,khả,gia
嘿	mặc,hắc
议	nghị
胉	bác
榕	dong,dung
屡	lũ
钞	sao,sào,sáo
髐	hiêu,hao
嶧	dịch
沁	thấm,sấm
忩	thông
挏	đồng
靸	táp
騷	tao
翍	phi
梅	mai
艗	ích,dật
馴	huấn,tuần
骗	phiến,biển
萝	la
凍	đông,đống
彍	khoắc,khoách
畷	chuyết
鰿	trách
鏡	cảnh,kính
玼	thử,tỳ
囓	khiết,niết,ngão
逾	du,dũ
鑛	quáng,khoáng
濮	bộc
寕	ninh
唠	lạo,lao
绝	tuyệt
啥	xá
胧	long,lung,lông
誳	quật
珣	tuân,tuần
梓	tử
砗	xa
绕	nhiễu
隥	đặng
鳎	tháp
肻	khẳng
猫	miêu
异	di,dị
礱	lung
说	thuyết,duyệt,thoát,thuế
矞	duật,húc,quyệt
械	giới
蠒	kiển
舋	hấn
郛	phu
漆	tất,thế
屎	hy,thỉ,hi
镏	lựu,lưu
顢	man
核	hồ,hạt,hạch
箅	ty,bế
碗	oản,uyển
镀	độ
衝	xung
宊	đột,gia
蹰	trù
隴	lũng
喔	ốc,ác
騺	chí
猬	vị
焖	muộn
儲	trữ,trừ
腫	trũng,thũng
怓	nao
忱	thầm
寐	mị
贕	độc
躦	toàn
讷	nột
遒	tù,tưu
蠆	mại,sái
跽	kị,kỵ
冘	dâm
屯	truân,đồn
膎	hài
翊	dực,lạp
痚	hiêu
凓	lật
褲	khố
衲	nạp
钮	nữu
觱	tất
犮	bạt
镰	liêm
骈	biền
狊	hích
蔞	lâu,liễu
鶇	đông
弥	my,di
摛	si
屧	tiệp
捖	hoàn
鷧	ý
馅	hãm
钟	chung
莱	lai
鼚	sương,xương
姶	hấp,ấp
龠	dược,thược
靓	tịnh
靇	lung,linh
岋	ngập
幕	mán,mộ,mạn,mạc,mô
鼢	phân,phẫn
謖	tắc
絖	khoáng
欝	uất
兼	kiêm
殍	biễu,biểu
黱	đại
弔	đích,điếu
缃	tương
禸	nhựu,nhụ
晃	hoàng,hoảng
瀕	tần,tân
扳	phan,bản,ban
淮	hoài
诩	hủ,hu
菀	uất,uẩn,uyển
犂	lưu,lê
哆	xỉ,sỉ,đá
鼉	đà
塗	đồ,độ,trà
邵	thiệu
牌	bài
醽	linh
朗	lãng
哧	xích,hách
炊	xuy,xúy
鸒	tư,dư
襰	lại
孙	tôn,tốn
够	cấu,hú,câu,cú
煤	môi
鐫	tuyên
寔	tẩm,thật,thực
賡	canh
壟	lũng
夥	khỏa,khõa,hỏa
虪	thúc
項	hạng
鑫	hâm
繩	mẫn,thằng
幼	yếu,ấu
卭	cung,ngang
剽	phiểu,phiếu,phiêu
驿	dịch
魷	vưu
鏊	ngao
睐	lãi,lai
獆	hào
鵗	hy
雅	nhã,nha
脾	bễ,tì,bài,tỳ
镉	cách
繣	hoạch
帠	nghễ
婞	hạnh,hãnh
氌	lỗ
攳	tầm
訄	khao,cầu,cừu
挟	hiệp,tiệp
禩	tự
獦	cát,hát,liệp
怞	du
豒	trật,dật
㧑	huy
厉	lệ,lại
脶	loa
猰	nghiệt,khiết,trát
括	quát,hoạt
鄜	phu
踳	suyễn,xuẩn
翛	tiêu,dựu
檔	đáng,đương
峨	nga
鱅	dong,dung
氍	cù
逷	thích,địch
伃	dư
袭	tập
蒱	bồ
鋙	ngữ,ngô
鄒	trâu
琫	bổng
烜	huyễn,huyên,hủy,hối
标	tiêu,phiêu
帖	thiếp,thiệp
窌	giáo
胡	hồ
懞	mộng,mông
桁	hãng,hàng,hành
粉	phấn
杹	hóa
紏	thẩu,củ
捘	tuấn
豎	thụ
澑	lựu,lưu
夾	giáp
詾	hung
逵	qùy
璩	tuyền,cừ
民	miên,dân
踝	khỏa,hõa,hỏa,khõa
妺	muội,mạt
麑	nghê
庀	phỉ
疹	chẩn
挝	qua
媒	môi
过	qua,qúa
衋	hức,hực
亜	á,a
贻	di
櫈	đắng
隕	vẫn,viên
璣	ky,ki
进	tiến,tấn
葬	táng
觶	chí,chi
悬	huyền
肤	phu
供	cung,cúng
漷	khuếch
媿	qúy
顓	chuyên
堶	đọa,đà
栩	hú,hủ
衂	nục
跡	tích
鲨	sa
芑	khỉ
厶	khư,mỗ
祈	kỳ,kì
鉉	huyễn,huyền
蒲	bạc,bồ
駛	sử
鋌	thính,đĩnh
狚	đán
崚	lăng
涆	cán
滻	sản,ngạn
獋	hào
爟	quán
羐	dữu,dũ
篠	tiểu
眉	my,mi
诳	cuống
狣	triệu,a
溎	quế,yến
唕	tạo
洝	át,án
篧	trạc
廻	hồi
韌	nhận
驪	ly,li
直	trực,trị
麀	ưu
綉	tú
谽	hàm
艖	xoa
暉	huy
蠰	nhương,nhưỡng
鄧	đặng
摽	tiêu,phiếu,phiêu
喢	sáp
炫	huyễn
捋	liệt,loát
曨	lung,lông
兀	ngoạt,ngột,ô
枵	hiêu
抌	thẩm
叀	chuyên
鎛	bác
磠	lỗ,nạo
緡	mân,mẫn
鬮	cưu
甜	điềm
繯	hoàn,hoạn,hoán
秾	nùng
絃	huyền
跚	san
龎	bàng
棗	táo,tảo
鋝	luyệt
鑼	la
拼	banh,phanh,bính
袑	thiệu
毎	mỗi
香	hương
訾	ty,tí,ti,tý,tỳ
脠	thiên
湯	thãng,sương,thang
驸	phò,phụ
釅	nghiễm,nghiệm
裀	nhân
鍵	kiện
澓	phục
鈇	phu
羳	phiền
煖	noãn,huyên
唔	ngô,ân,mô
终	chung
偽	ngụy
逶	uy
輦	liễn
鍺	giả,đả
襀	tích
悕	hy
奄	yểm,yêm
勳	huân
秈	tiên
獗	quyết,quệ
凈	tịnh
煎	tiễn,tiên
墁	mạn
鞁	bị
虇	quyền
腻	nị,nhị
莖	hành
僿	tái
祐	hữu,hựu
癌	nham,ngai
馞	bột
垫	điếm
竈	táo
驻	trú
绺	lữu
骋	sính
嚈	áp
柬	giản
勴	lự
挶	cúc,cư
螽	chung
籐	đằng
羅	la
飂	liêu
窣	tốt
浯	ngô
蕻	hồng,hống
钚	bất
僰	bặc
奚	hề
匕	trủy,tỷ,chủy
齗	ngân
裼	tích,thế
载	tải,tái,tại
婉	uyển
邬	ổ
廋	sưu
畤	trĩ,chỉ
任	nhiệm,nhậm,nhâm
餤	đạm,đàm
剭	ốc
盜	đạo
伴	phán,bạn
鋊	dụ,dục
酽	nghiễm,nghiệm
嵷	tung
蝺	khủ
軥	câu,cù
汇	vựng,vị,hội,hối
丙	bính
林	lâm
胕	phu
欷	hy,hi
飫	ốc,ứ
蓀	tôn
鸤	thi
缸	cương,cang,ang,hang
蠼	quắc,quặc
臺	thai,đài
犇	bôn
釙	phốc,bộc
吽	oanh,ngầu,hống,ngâu,ẩu,hồng
点	điểm
虙	phục,mật
觊	ký,kí
孼	nghiệt
霼	hý
贮	trữ
毀	hủy
概	khái,hị
襯	sấn
恺	khải
隊	trụy,toại,đội
蟂	kiêu
龆	điều
挾	hiệp,cáp,tiệp
迪	địch
蜌	bệ
俒	hoàn
啃	khẳng
愳	cụ
诸	gia,chư
嬛	hoàn,quỳnh,huyên
喴	uy
婠	oan,oát,loan
溇	lâu
胾	chí,truy
籠	lộng,lung
偩	phụ
卸	tá
稷	tắc
僄	tiêu,phiếu,phiêu
鷩	tế
戵	cù
俎	trở
鴽	như
慖	quắc
堋	bằng
蹴	xúc,thúc
楔	kiết,tiết
塃	hoang
枭	kiêu
鮄	phất
砣	đà
殉	tuận,tuẫn
霽	tế,tễ
栔	khế
杂	tạp
肮	hàng,khảng
眍	khu
贸	mậu
䀹	tiếp
膐	lữ
蓄	súc
帋	chỉ
曆	lịch
绤	khích
笼	lộng,lung
歲	tuế
耨	nậu
凴	bằng
嗛	khiểm,khiêm,hiềm,khiếp,hàm
貯	trữ
誡	giới
効	hiệu
檍	ức
既	ký,kí
育	dục
搿	cách
杀	sái,sát,tát
婥	xước,sước
橧	tằng,tăng
鱭	tễ
涩	sáp
访	phỏng,phóng
豭	gia
奔	phẫn,bôn
麓	lộc
谨	cẩn
覅	yếu,vật
愖	đam,thâm,kham
哑	ách,á,a,nha
戉	mậu,việt
対	đối
胠	khư
兔	thỏ,thố
庫	khố
爂	tiêu
淏	hạo
浛	hàm
傀	qủy,khổi,khôi,ổi
歊	hiêu
檗	phách,nghiệt,bách
著	trứ,trước,trữ
恁	nhẫm,nhậm
彳	sách,xích
俣	vũ
纝	luy
檋	cúc
钩	câu
銴	phản
煙	yên
稔	nhẫm,nẫm
泠	linh
濒	tần,tân
棓	bang,bạng,bội
牻	mang
褒	bao,bầu
麂	kỉ,kỷ
峒	đỗng,động,đồng
顆	khỏa,khõa
羮	canh
缹	phữu
遙	dao,diêu
鹯	chiên
莢	giáp
禊	hệ,hễ
玗	vu
韔	xướng,sướng
婺	vụ
輭	nhuyễn,nhuyến
慉	súc
譸	trù
窎	điếu
澍	thụ,chú
揥	đế,thế
闔	hạp
葐	phần
脂	chi,chỉ
諾	nặc
藇	tự
汾	phần
鹗	ngạc
诫	giới
羵	phần
忿	phẫn
紊	vặn,vấn
撰	soạn,chuyển,toán,tuyển
蚀	thực
怍	tạc
譿	tuệ,huệ
烶	diễn
幎	mạc,mịch
痒	dưỡng,dương,dạng
闷	muộn,bí
薐	lăng
繘	quất
稺	trĩ
弆	khí,cử
雹	bạo,bạc
罴	bi
仳	tỷ,tỳ
蠪	long
燊	sân
芤	khưu
驌	túc
镶	tương
篚	phỉ
淇	kỳ,kì
騈	biền
勷	nhương
忳	truân,đồn,chuân
柩	cữu
螨	mãn
掽	bánh,bính
乙	ất
段	đoạn,đoán,đoàn
廿	nhập,chấp,trấp
彐	tuyết,ký,kệ
讇	siểm
赏	thưởng
篛	nhược
靣	diện
唄	bại,bối,bái
楛	khổ,hộ
輻	bức,phúc
筮	phệ,thệ
彦	ngạn
趣	xúc,thú
藘	lư
瞤	thuấn,nhuần,nhuận,thuần
曶	hốt
喘	suyễn
贄	chí,trập
轏	sạn
庢	chí,trất
豦	cứ
箏	tranh
縌	nghịch
敠	uyết,xuyết
系	hệ
莴	oa
趁	sấn
荤	huân
灵	linh
槔	cao
歇	hiết,yết,tiết
控	khoang,khống
渊	uyên
密	mật
侨	kiều
声	thanh
屈	khuất,quật
籧	cừ,cử
鍍	độ
徯	hề,khê,hễ
緬	miến,diến,miễn
礁	tiêu,tiều
骞	khiên,kiển
杧	mang
旁	bàng,phang,banh,bạng
鈥	hỏa
嫇	minh
苈	lịch
啷	lang
迍	truân
筆	bút
暤	hạo
姸	nghiên
皷	cổ
懨	yêm
耤	tá,tịch
壛	diêm
瀸	sàm,tiêm
寻	tầm
冞	my
馤	ái
骢	thông
髧	đạm,đãm,đảm
鯤	côn
苟	cẩu
离	lệ,ly,li
鑪	lư,lô
畎	quyến
馒	man
怦	phanh
格	các,cách
做	tố
搅	giảo
魅	mị
撘	đáp
钁	quắc,quyết,quặc
伝	truyền,truyện
鞮	đê
甃	trứu
蹢	đích,trịch
縣	huyện,huyền
轹	lịch
扜	hu
摒	tính,bính
篪	trì
腐	hủ,phụ
縩	sái
胤	dận
褼	tiên
揩	giai,khai
樾	việt
伀	chung
爞	trùng
卨	tiết
呃	ách
齁	câu,hâu,hầu
袽	như
搭	tháp,đáp
蛸	sao,tiêu
偟	hoàng
憇	khế
袏	tá
沺	điền
緒	tự
缫	tao,tảo,sào
喆	đề,triết
瀰	my,nhị,di
恼	não
凤	phụng,phượng
笾	biên
勐	mãnh
獳	nậu
暠	hạo,cảo
氈	chiên
摐	song
珲	huy,hồn
韨	phất
圂	hộn,hỗn,hoạn
簨	soạn,tuẩn
土	độ,thổ,đỗ
芘	tý,tỷ,ti,tỉ
鲧	cổn
倡	xướng,xương
醇	thuần
癇	giản,nhàn
蜃	thận
豶	phần
构	cấu
掀	hiên,hân
氢	khinh
蒐	sưu
瓏	lung
崬	đông,đống
陬	tưu
腽	ốt,ột
舱	thương
鼈	biết,miết
嫁	giá
碱	kiềm,giảm,dảm,kiểm,thiêm
孟	mãng,mạnh
脛	hĩnh
鴣	cô
叡	duệ
仿	phỏng,phảng
隫	phần
佢	cự,cừ,cử
郴	sâm
氫	khinh
戚	xúc,thích
快	khoái
鬵	tiềm,tầm,tẩm
接	tiếp
辮	biện
瀙	sấn
喙	huế,uế
縐	sứu,trứu
祟	trúy,túy,chúy
卹	tuất
壬	nhậm,nhâm
堥	mâu
蕋	nhị
凄	thê
皤	bà
芄	hoàn
鸦	nha
攷	khảo
悈	giới,cức
騉	côn
杻	sứu,nữu,sửu
峣	nghiêu
緥	bảo
舊	cựu
黉	huỳnh
汲	cấp
嵫	tư
稝	banh
魁	khôi
躘	lung,lúng,lũng
鮟	án
钂	đảng
啇	đích
諧	hài
嗸	ngao
憧	sung,tráng,xung
蒹	kiêm
垚	nghiêu
畝	mẫu
質	chí,chất
萁	ky,ki,kỳ
虫	trùng,hủy
䔿	tỗn
圌	thùy,chùy,thuyên,đoàn
倅	thối,toái,tốt
甾	chuy,tai,tri
蚦	nhiêm,thiệm
綅	xâm,tiên,tiêm
黌	huỳnh
嬈	niêu,liểu,niểu,nhiêu,nhiễu
毵	tam
鲠	ngạnh
诈	trá
寖	tẩm
檾	khoảnh
歐	ẩu,âu
倩	thính,thiến,sai,sảnh
盤	bàn
咪	mễ,mị
軟	nhuyễn
蠷	cù
龞	miết
茅	mao
鹓	uyên
喲	ước,yêu
娲	oa
岑	sầm
霸	phách,bá
扙	trượng
嗳	ái,ai
臜	trâm,châm
炖	đôn,đốn,đồn
殔	dị
叛	phán,bạn
鲲	côn
訂	đính
蟷	đương
跖	chích,thác
貜	cước,quặc
朔	sóc
衷	trung,chung,trúng
廒	ngao
卝	khoáng,quán
諶	thầm,kham
呴	cấu,câu,hấu,ha,hú,hống,hu,hứa
滁	trừ
繾	khiển
赘	chuế
偭	miến,mạn,diện
經	kinh
刓	ngoan
解	giới,giái,giải
肚	đỗ
盻	phán,hễ
痰	đàm
揬	đột
提	đề,để,thì
飣	đính
耗	mao,háo,mạo,hao
淞	tùng
肩	khiên,kiên
圯	di
勊	khắc
翀	trưng,xung
㒿	ly
开	khai
犓	xu
闆	bản
輤	thiến
蜬	hàm
湘	sương,tương
蹹	tháp
慚	tàm
靑	thanh
滦	loan
䅟	sam
淘	đào
筚	tất
煉	luyện
逡	thuân
袌	bão,bào
恫	thông,đỗng,động,đồng
埄	canh,đãng,phủng,bổng
琢	trác
瞡	quy
翓	hiệt
芙	phù
萇	trường,trành
楦	huyên,tuyên
犫	thù,sưu
钯	bả,ba
糔	tưu
欛	bá
奇	kỳ,kì,cơ
覵	kiến,gián
厹	nhữu,nhu,cầu
绳	thằng
銚	diêu,điệu,dao,điêu,điều
圉	ngữ,ngự
稣	tô
嶁	lũ
衮	cổn
鑌	tấn,tân
翫	ngoạn
苎	trữ
岷	mân,dân
骖	tham
褊	biền,biển
顚	điên
夊	truy,tuy
鄟	chuyên
覰	thứ
稌	đồ
堡	bảo
阶	giai
咑	đát
顗	nghĩ,ỷ
噒	liên
湜	thục,thực
殒	vẫn
蹩	biết,biệt
饾	đậu
坡	pha,ba
憘	hy,hỷ
杆	can,hãn
隷	lệ
龍	long,sủng,lũng
摭	chích,trích
郫	bì
辫	biện
趿	tát,táp
関	quan
艞	thiếu,diệu
筁	khúc
呝	ách
鞅	ưởng,ương
鷄	kê
癰	ung
梗	cánh,ngạnh,cạnh
鳳	phụng,phượng
豳	bân
詍	duệ
评	bình
俨	nghiễm
唐	đường
痐	hồi
舵	đà
胜	tinh,thăng,thắng
鶅	chuy
群	quần
瓷	từ
级	cấp
儚	mộng,manh
占	chiêm,chiếm
瘯	thốc,tộc
考	khảo
褃	khẳng
掌	chưởng
樁	thung,trang,chang
鰤	sư
拗	nữu,ao,áo,húc,ảo
倫	luân
輟	chuyết,xuyết
貹	sính
鮮	tiển,tiên
肠	tràng,trường
轜	nhi
睿	duệ
顣	xúc,túc
偘	khản
霢	mạch
綽	xước
嘍	lâu
癐	uy
咨	tư
瑘	da,gia
赁	nhẫm,nhấm
鎘	lịch,cách
娩	vãn,phiền,miễn
歍	ô
降	giáng,hàng
厎	để,chi,chỉ
綌	khích
棰	trùy,chủy
卬	ngang
僛	khi
嵕	tông
攡	ly
豊	lễ,phong
摹	mô
瘩	đáp
錤	ky,cơ
携	huê
輾	niễn,niển,triển
尠	tiển
日	nhựt,nhật
祓	phất
偨	sai
儭	thân,sấn
儁	tuấn
啡	phỉ,phôi,phi,phê
雩	vụ,vu
钛	thái
薕	liêm
矘	thảng
堝	oa,qua
騮	lưu
蒕	uân
铷	như
噪	táo
詼	khôi
蛋	đản
花	hoa
迁	thiên
俛	miễn,phủ
玟	mân,văn,mai
氿	qũy,cửu
顜	giảng
鰔	cảm
舘	quán
麰	mâu
菪	đãng
暖	noãn,huyên
沆	hãng,hàng
騭	chất
鍩	nặc
幱	lan
砾	lịch
曟	thần
咥	điệt,hí,hý
冃	mạo
徵	trủy,trừng,trưng,chủy
厮	tư
毉	y
縲	luy
机	kì,ky,ki,kỷ,cơ
楅	bức,phúc
鄦	hứa
鞔	muộn,man
蔓	mạn,man
喀	ca,khách
硋	ngại
耊	điệt
谔	ngạc
夠	cấu,hú,câu,cú
污	ố,ô
呫	chiếp,triệp,triệt,thiếp,xiếp
哏	ngận
墆	điệt,đệ
緦	ty,tư,ti
頍	khởi,qũy,khuể
憶	ức
臭	xú,khứu
穗	tuệ
赭	giả
墬	địa
撮	toát
絁	thi
擥	lãm
琴	cầm
陈	trận,trần
镑	bàng,bảng
鶋	cư
緍	mân
怊	siêu
葸	tỷ,tỉ
规	quy
鼏	mịch
窭	lũ,cũ
楝	luyện
鍶	tư,tung
蝳	đại
莞	hoàn,quản,hoản,hoán
轳	lư,lô
熇	hác,hốc,khảo
猕	my,mi,di
幷	bính,bình,tịnh,tinh,tính
袿	khuê
遯	độn
剃	thế
沉	trầm,thẩm,trấm
貳	nhị
煞	sát
衣	y,ý
慸	đế,sái,sại
铿	khanh
总	tổng
敃	phân,mân,mẫn
飖	dao,diêu
襚	tụy,toại,tùy
繡	tú
姒	tỷ,tự,tỉ
剤	tễ
烛	chúc
邳	phi,bi
驏	sạn
豫	tạ,dự
埤	tỳ,bì,bi
霧	vụ
駖	nghiệm
钜	cự
滲	sâm,sấm
俖	bội
鎁	da
火	hỏa
彜	di
来	lãi,lai
寳	bửu,bảo
鳱	hạn
藤	đằng
歴	lịch
螺	loa
嘉	gia
營	doanh,dinh
壮	tráng,trang
睏	khốn
析	tích
偓	ốc,ác
武	vũ,võ
慤	khác,xác
呕	hú,ẩu,âu
璉	liễn
鲜	tiển,tiên
洄	hồi
詧	sát
硁	khanh
磛	sàm
橕	sanh,xanh
梹	tân
凸	đột
詘	khuất,truất
矸	ngạn,can
怳	hoảng
鷽	hạc
憋	biết,biệt,miết
輅	nhạ,lộ,hạch
侦	trinh
军	quân
胑	chi
嘁	thích,táp
嫒	ái
侰	quẫn
齑	tê
绮	khỉ,ỷ
瘧	ngược
屹	ngật
蟩	quyết
荡	đãng,đảng
卵	noãn,côn
薢	giải
牀	sàng
慹	triệp,chấp,niệp
惺	tinh,tỉnh
弁	biền,biện,bàn
膛	thang
瘰	loa,lõa,lỗi
劊	khoái,quái
北	bắc,bối,bội
儌	kiêu
価	giá
蝡	nhuyễn
跧	thuyên
涷	đông
韊	lan
填	trấn,điền,trần
幓	sam,sâm
浄	tịnh
鄙	bỉ
豽	nột
趠	trác
庑	vũ,vu
絓	quai,quái
菎	côn
鄋	sưu
盗	đạo
饦	thác
栀	chi
洎	kỵ,kịp
唴	khảng
祥	tường
騅	chuy
戭	diễn,dẫn
颕	dĩnh
鬷	tông
憤	phẫn,phấn
涐	nga
鴄	thất
耇	cẩu,củ
酤	cô
沫	mạt
斑	ban
嘰	cơ,ki,ky,kỷ
乐	nhạo,lạc,nhạc
辤	từ
鞳	tháp
毈	đoạn
圓	viên
韄	hoạch
櫅	tễ
谎	hoang
沌	độn
革	cức,cách
鎮	trấn
强	cưỡng,cường
樹	thụ,thọ
帊	phạ
烦	phiền
醻	thù,đạo,trù
与	dữ,dự,dư
哪	na,nả,ná
兗	duyện,duyễn
须	tu
劎	kiếm
埽	tảo
崆	khoang,không
娸	kỳ,khi
翣	sáp
鴯	nhi
諩	phả,phổ
湥	thốc
仭	nhận
瀢	đỗi
廆	hối
鉧	mẫu
咏	vịnh
操	thao,tháo
兾	ký,kí
竜	long
鼱	tinh
渃	nhược
椈	cúc
騢	hà
搓	sai,tha
茦	sách
绫	lăng
藈	qùy
籬	ly,li
玠	giới
䌷	trừu
狆	trung,trọng
傳	truyền,truyện,truyến
澇	lão,lạo,lao
軺	dao,diêu
佤	ngõa
櫗	miết
犴	ngạn,ngan,hãn
铻	ngữ,ngô
進	tiến,tấn
兎	thố,thỏ
加	gia
坭	nê
灺	đả,tã
拣	giản,luyến
抏	ngoạn,ngoan
布	bố
广	quáng,nghiễm,quảng,yểm
梵	phạn,phạm
蹡	thương
墱	đặng
睄	sảo
狝	tiển
軔	nhận
丱	quán
檁	lẫm
旾	xuân
灰	hôi,khôi
誑	cuống
鳗	man
袴	khố
炳	bỉnh,bính
趲	toản
饰	sức
恰	cáp,kháp
湒	tập
禾	hòa
斳	cần
眔	đạp
隔	cách
荞	kiều
銑	tiển,tiên
顑	kham
咲	tiếu
猇	khiêu,hao,hổ
鹣	kiêm
蜺	nghê
昵	nật,nễ,nặc,chức
隶	đãi,lệ
蔴	ma
錐	chùy,trùy
涽	hôn
眎	thị
踅	tuyệt,sế,tiết,thệ
殇	thương
兹	ty,tư,từ
谉	thẩm
尌	thụ
菉	lục
锭	đĩnh
儥	dục,độc
猎	liệp,lạp
瑊	giam
晣	triết
枌	phần
齪	xúc,sức
粺	mại,bại
褶	triệp,tập,điệp
栘	di
苻	phù
堌	cố,cổ
鈤	nhật
绥	thỏa,nhuy,tuy
澥	giải,hải
敕	sắc
界	giới
獩	uế
弘	hoằng
被	bí,phi,bị
翕	hấp
斂	liệm,liễm
弎	tam
蟲	trùng
燉	đôn,đốn
酉	dậu
噣	trụ,trú,trác
缛	nhục
萵	oa
戛	kiết
濂	liêm
捓	da,gia
詈	lị
蘢	long,lung
靚	tịnh,tĩnh
墉	dong,dung
怅	trướng
吹	xuy,xúy
侷	cục
悦	duyệt
葽	yêu
楞	lăng
话	thoại
懭	khoáng
茭	giao,hảo,kích
铩	sát
犚	úy
锘	nặc
削	tước,sảo
饮	ấm,ẩm
軆	thể
㺿	cơ,di
灒	tán
村	thôn
俍	lương,lang
蘄	kỳ,kì,cần
驁	ngạo,ngao
尔	nhĩ
陸	lục
霅	sáp,tráp,hiệp
巋	khuy,vị
侈	xỉ
炮	pháo,bào
潇	tiêu
葯	dược,ước
蓣	dự
崁	khám
廳	thính,sảnh,thinh
弄	lộng
观	quan,quán
蚵	hà
嬃	tu
媸	xi,xuy,si
佈	bố
蹧	tao
觰	xa
嵂	luật
屣	xí,tỷ,tỉ
続	tục
讏	vệ
猊	nghê
靽	bạn,bán
霚	vụ
冩	tả
蠏	giải
举	cử
暎	ánh
鰝	hạo
杠	cống,giang
赤	thích,xích
鵬	bằng
遮	già
窃	thiết
怹	đan,than
嬾	lại,lãn
檟	giả
鬄	thích,thế
崧	tung
储	trữ,trừ
耋	điệt
薺	tề,tể
錸	lai
裣	liêm,liễm
莶	hiêm,thiêm
餅	bính
鹬	duật
摩	ma
谳	nghiện
嗡	ổng,ông
辍	chuyết,xuyết
籲	dụ
堦	giai
訽	cấu
珉	mân,dân
惋	oản,uyển
蘌	ngự
猒	yêm
慝	thắc
襏	phất,bát
釘	đính,đinh
躁	táo
鐾	tý
稏	á
蕝	khiêu,tuyệt,toát
餮	thiết
裮	xương
拶	tạt
鈕	nữu
绵	miên
朁	thảm
磯	ky,ki
紀	kỉ,kỷ
鱎	kiểu
磺	hoàng,khoáng
娄	lũ,lâu,lu
掜	nghiệt,nghễ
冢	trũng,trủng
翯	hạc
月	nguyệt
隹	chuy
穜	chủng,chúng,đồng
潲	sảo
囼	thai
穨	đồi,đôi
摄	nhiếp
监	giám,giam
迫	bách,bài
緗	tương
孶	tư,tứ
姿	tư
捵	điến,điền,nhiên
帡	bình
犊	độc
沿	duyên,diên
廝	tư
誤	ngộ
砲	pháo
懝	ngại
瑄	tuyên
徊	hồi
逊	tốn
瞛	thung
蕄	manh
棋	ký,kì,kí,ky,kỳ
瘲	túng
袁	viên
癜	điến
戅	tráng
睚	nhai
泒	cô
侭	tẫn,tận
匼	ảm,hạp
秒	miễu,miểu
箈	đài
鎳	niết
趸	độn
菁	tinh,thiến
昽	lung,lông
乘	thặng,thừa
牢	lâu,lạo,lao
莉	lị,lê
蒇	sản,siển
梠	lữ
昶	sưởng,sướng
吐	thổ
汗	hãn,hạn,hàn
傭	dong,dung,dũng
澟	lẫm
特	đặc
睇	đê,thê,đệ
狥	tuân,tuẫn
歹	đãi,ngạt
獲	hoạch
纯	chuẩn,truy,đồn,thuần
般	ban,bát,bàn
壈	lẫm
詒	đãi,di
炷	chú
榲	ốt,ôn,uấn
咁	cám,hàm
谊	nghị
筴	hiệp,kiệp,sách,giáp
滍	trĩ
礏	ngập
阔	khoát
蓰	tỷ,sỉ,si
暧	ái
堕	huy,đọa
貍	uất,ly,li,mai
佟	đông,đồng
喻	dụ,du
钤	kiềm
湼	nát,niết
蠳	anh
束	thú,thúc
粋	túy
骽	thối,thù
鶾	hàn
鲚	tễ
踠	oản,uyển
豓	diễm
芵	quyết
鱖	quyết
姮	hằng
槕	trạo,trạc,trác
徃	vãng
揅	nghiên
鄾	ưu
膝	tất
軜	nạp
吂	mang
闤	hoàn
赌	đổ
菖	xương
併	tính
鞴	bố,bại,bị
溉	khái,cái
薜	phách,bệ,bách
欎	uất
倣	phỏng,phảng,phóng
砼	đồng
俉	ngộ
才	tài
粞	tê
邧	nguyên
摟	lâu
脮	hoái
罱	lãm
沬	huệ,muội,mội,hối
菷	trửu,chửu
淈	cốt
酹	lỗi,lội
僞	ngụy
陡	đẩu
蹑	niếp,nhiếp
孅	thiêm,tiêm
拮	cát,kiệt,kiết
痡	phu,phô
彀	cấu
娑	sa
芯	tâm
材	tài
踛	lục
忮	kĩ,kỹ
蹶	quyết,quệ
劓	tị,tỵ,nhị
鶗	đề,ninh
琅	lãng,lang
髍	ma
鋋	diên
絍	nhâm
奪	đoạt
𩬑	chiêm,điêm
摅	sư
幜	cảnh
幀	tránh
昌	xương
埝	niệm
毺	su,du
僌	tải,tái
刚	cương,cang
鴃	quyết
蕖	cừ
鏘	thương
鸎	oanh
霑	triêm,thiêm,tiêm
僶	mẫn,miễn
諷	phúng
番	phan,phiên,ba,bà
脇	hiếp
噦	uyết,hối,uế
鎩	sái,sát
陋	lậu
揽	lãm
趾	chỉ
縹	phiếu,phiêu
电	điện
谝	biển
囋	tán
匣	hạp
窊	oa
州	châu
逗	đậu
譨	nông,nưu
季	qúy
黹	chỉ
绎	dịch
愙	khác
犽	nha
溭	tắc
竟	cánh,cảnh
枷	giá,già,gia
嘅	khái
韭	cửu
碭	đãng,nãng,nương
箲	tiển
挖	oạt,oát
蛹	dõng,dũng
覻	thứ
礟	pháo
嗙	bang,bảnh
盝	lộc
僱	cố
栱	củng
菢	bão
句	cấu,câu,cú
栚	trẫm
骴	tỳ
纳	nạp
鰂	tặc
誹	phỉ
蠓	mông
杬	nguyên,ngoạn
袄	áo
閻	diêm,diễm
屢	lũ
嗩	tỏa
廕	âm,ấm
岏	hoàn,ngoan
扥	đốn,thác
匀	quân
邛	cung,cùng
崮	cố
畴	trù
鉼	bính
趭	tiếu
葫	hồ
萍	bình
荐	tiến,tấn,trãi
蠙	tần,tân
鹪	tiêu
捱	ngai,nhai
㱩	độc
鴗	lập
夏	giá,hạ,giạ
鮚	cát,kết
忐	khẩn,thảm
靘	sảnh
鋱	thắc
负	phụ
鯛	điêu
鍴	đoan
惧	cụ
鵉	loan
臏	tẫn,bận
蹐	tích
帜	xí
扎	trát
搇	khấm
桚	tạt
裛	ấp
禪	thiền,thiện
汱	kiển
襣	tỵ
軬	bổn,phạn
隗	ngỗi,ngôi
荙	đạt
恟	hung
聇	sỉ
羈	cơ,ki,ky
玖	cửu
鑋	khinh
镆	mạc
榫	chuẩn
焯	chước,trác
鸐	địch
妝	trang
魳	sư
鳖	biết,miết
嶗	lao
棼	phần
烘	hồng
愊	phúc,phức
鹆	dục
姗	san,tiên
褷	si
諄	truân,chuân
鸗	long
阽	điếm,diêm
蝇	dăng
涯	nhai
抨	phanh,bình
穿	xuyến,xuyên
泗	tứ
嶇	khu
癯	cù
忻	hân,hãn
儘	tẫn,tần,tận
科	khoa
晶	tinh
崣	khụy,ủy
總	tổng,tông
臬	nghiệt,niết
筊	hào,giảo
延	duyên,diên
珎	trân
圍	vy,vi
陞	thăng
懸	huyền
孬	khoái,nạo
爭	tranh,tránh
紫	tử
罸	phạt
腳	cước
鼺	luy
蹈	đạo
慫	tủng,túng
洫	hức,dật
络	lạc
櫜	cao
潛	tiềm
硨	xa
鮊	bách,bạc
曚	mông
郊	giao
餃	kiểu,giáo,giảo
梀	tốc
膱	chức
娒	mỗ
褯	tạ
圢	đỉnh,đinh
脽	thùy
憊	bại,bị
垻	bá
饪	nhẫm
锔	cư,cục
矫	kiểu
細	tế
啔	khải
頒	phân,phần,ban
髣	phảng
丆	duệ,hán
酪	lạc
左	tả,tá
蜠	quẫn
粔	cự
碴	tra
膠	giao
唸	điếm,niệm
鰷	điều
禳	nhương
蟢	hỷ,hỉ
嗷	ngạo,ngao
翥	trứ,chứ
蘼	my,mi
崳	du
裚	tiết
竪	thụ
鲂	phường
爬	ba,bà
炻	thạch
疇	trù
噁	ố,ác
硌	các,lạc
醝	ta
鎔	dong,dung
闊	khoát
謫	trích
刳	khô
缊	ôn,uẩn,uân
艇	đĩnh
鸫	đông
盒	hạp
臾	du,dũng
壱	nhất
琖	trản
聡	thông
酇	tán,ta,toản
錩	xương
鹇	nhàn
飀	lưu
鈣	cái
资	tư
数	xúc,sổ,số,sác
漍	quắc
毒	đại,đốc,độc
蔤	mật
鲉	trừu,du
痫	giản
丹	đan,đơn
迳	kính
衖	hạng
耈	cẩu,củ
儡	lỗi
阙	khuyết
俞	du,dũ
遼	liêu
忧	ưu
膮	hiêu
貘	mạc,mô,mạch
瘈	khế,khiết,xiết
煏	phúc,phức
偍	đề
慙	tàm
愠	uấn
餩	ách
蕕	do,du
篌	hầu
钕	nục
艰	gian
阆	lãng,lang
灶	táo
镟	tuyền
谻	cược
孹	phách
璈	ngao
銷	tiêu
鼊	bích
泯	miến,dân,dẫn,mẫn
镸	trường
跺	đọa,đóa
転	chuyển
倉	thảng,thương,sảng,xương
鮰	nguy
颏	cai,hài
立	lập
廧	tường
煦	hú
糶	thiếu
期	kì,ky,kỳ,ki,cơ
僢	xuyển,xuyên
莳	thi,thì
劙	ly
找	hoa,qua,trảo
擦	sát
剡	diệm
诰	cáo
豱	ôn
镳	tiêu
颂	tụng
觞	thương,tràng,trường
骎	xâm
磒	vẫn,vận
瑲	thương
噓	hư
氠	tiên
薹	đài
脈	mạch
髏	lâu
揶	da,gia
恿	dũng
壼	khổn,hồ
髻	kế,cát,kết
尹	duẫn,doãn
啅	trác
鷲	thứu,tựu
蹚	thang
巟	hoang
韉	tiên
斷	đoạn,đoán
具	cụ
栟	kiên,bôn
礌	lôi,lỗi
频	tần
藊	biển
睅	han,hạn
酮	đồng
昡	huyễn
蛕	hồi
真	chân
綯	đào
楙	mậu
玙	dư
弹	đàn,đạn
鑈	niệp
粳	cánh,ngạnh,canh
狈	bái
稙	trị,thực
焘	đảo,đào
睘	quỳnh
貴	qúy
騶	sô
凘	tư
憨	ham,hàm,hám
摓	phùng
欏	la
撫	mô,phủ
玫	môi,mai,mân
渐	tiềm,tiệm,tiêm
鈛	oa
蔽	phất,tế
閦	súc,sóc
鞃	hoành
壯	tráng,trang
嗊	cống
噴	phún,phôn
蹞	khuế,khuể
啘	uyển
黐	ly,li
駁	bác
抢	thưởng,thướng,sang,thương
戾	lệ,liệt
廪	lẫm
棒	bổng
郖	đậu
藴	uẩn,uấn
嬗	thiện
罻	úy
痄	trá,chá
醒	tinh,tỉnh
沭	thuật
鰋	yển
郗	hy,si
薌	hương
晩	vãn
颩	đâu,bưu
券	khoán
簴	cự
磙	cổn
聃	đam,tham
碹	tuyên
畾	lôi,lũy
軿	phanh,bình
霮	đạm
脰	đậu
抓	trao,trảo
孪	loan
韆	thiên
盯	đinh,trành
鬜	gian
薂	hịch
鲩	cán
陲	thùy
貽	di
浍	quái
酕	mao
泙	bàng,phanh,bình
暨	kị,kỵ
蚍	tì,tỳ
争	tranh,tránh
奸	gian,can
硅	khuê
殸	thanh
儈	khoái,quái
琊	da,gia
淢	vực,hức
賄	hối
谬	mậu
個	cá
枚	mai
拴	thuyên
葉	diệp,diếp
轺	diêu
蒋	tưởng,tương
姉	tỷ
轀	ôn,uẩn,uân
疸	đản,đáp
癫	điên
斡	oát,quản
扺	chỉ
愡	tổng
輯	tập
垮	khoa,khỏa
儒	nho,nhu
跁	bả,bá,bà
騑	phi
绰	xước
悄	tiễu,thiểu
棺	quan,quán
侌	âm
軌	qũy
嫢	quy
驠	yến
象	tượng,tương
纻	trữ
雯	văn
骾	cánh,ngạnh
救	cứu
仍	nhưng
尻	khào,cừu
娶	thú
蟟	liêu
圇	luân
硖	giáp
騁	sính
砵	bát
嬉	hy,hi
獰	nanh,ninh
謩	mô
脋	hiếp
论	luân,luận
蝩	chung,trùng
腯	đột
汤	thãng,sương,thang
䱇	thiện
勼	cưu
葟	hoàng
竱	chuyển
齐	tế,tê,tư,tề,trai
耲	hoài
鄢	yển,yên
縛	phọc,phược
琠	điển,thiến
邘	vu
楸	thu
荛	nghiêu,nhiêu
徇	tuân,tuần,tuẫn,tuấn
劚	chủ
碫	đoạn,đoán
喚	hoán
蟀	suất
繨	đáp
娖	sước,sác
膘	phiếu,phiêu
鬑	liêm
矢	thỉ,thi
碌	lựu,lục
橹	lỗ
菜	thái
貿	mậu
尀	phả
糈	tư,sở
饎	xí,sí
闈	vy,vi
鷗	âu
覂	phủng
什	thậm,thập
誙	khanh
奕	dịch
毾	tháp
维	duy
鋗	huyên,quyên
釋	thích,dịch
䮧	hàn
砜	phong
裲	lưỡng
渎	đậu,độc
譋	lan
糜	my,mi
豉	thị
鲷	điêu
鉻	các,lạc
蔷	sắc,tường
簽	thiêm
觔	cân
晽	lâm
銧	quang
渠	cự,cừ
躆	cứ
瞋	trấn,sân
篅	thùy
薟	hiêm,thiêm
镢	quắc,quyết
靃	hoắc
沨	phong
瞟	phiếu,phiêu
翭	hầu
朶	đóa
慯	thưởng
蹒	man,bàn
蝤	tưu,tù,du
拔	bạt,bội
鎦	lựu,lưu
峮	quân
銱	điếu
鈉	nạp,nột
槿	cẩn,cận
泭	phu
柽	sanh
渱	hồng
癭	anh
贐	tẫn
皫	phiếu
鹤	hạc
筭	toán
毆	ấu,ẩu,khu
浶	lao
葝	kinh,kính
毹	su,du
悀	dũng
汎	phạp,phiếm,phùng
鋟	tẩm,xâm,tiêm
幰	hiến,hiển
婐	ỏa,a
佸	quát
閌	kháng,khang
邂	giải
喂	ủy,uy,úy
漻	liêu,liệu
瑛	anh
茗	mính,minh
确	khác,xác
璆	cầu
賑	chẩn
邠	bân
酃	linh
逖	thích,địch
粥	dục,chúc
怄	âu
箧	khiếp
辂	nhạ,lộ
鐧	giản
纭	vân
鷓	giá,chá,gia
碏	tích,thước,thác
剞	ỷ,cơ,kỳ,kỷ,kỉ
兓	tán,tâm
熲	huỳnh,quýnh
鲿	thường
凖	chuẩn
糽	tranh,đinh
抃	biến,biện
捦	cầm
讄	lũy
澹	đam,đạm,đàm
疡	dương
迕	ngỗ
蚚	kỳ
摔	suất
蜴	dịch
額	ngạch
黥	kình
龘	đạp
归	quy
垵	am
裎	trình
圾	sắc,ngập
蟆	mạc,mô
橊	lựu,lưu
烋	hao,hưu
济	tế,tể
衄	nục
红	hồng
幂	mạc,mịch
迋	vượng,cuống,vương
谲	quyệt
鶱	hiên
囱	thông,song
壏	hám
矯	kiểu
臼	cữu
觢	sế
嚂	hảm,lạm
枸	câu,cẩu,củ
悇	dự
醾	my,mi
叼	điêu
醳	dịch
靿	áo
坵	khâu,khưu
谣	dao
徒	đồ
簙	bác,bạc
苬	tù
锺	chung
嚇	hách
摋	sát,tát
苛	kha,hà,ha
久	cửu
眙	sỉ,di,dị
趨	xúc,xu
掩	yểm
图	đồ
宥	hựu
豌	oản,uyển
輬	lương
裱	phiếu,biểu
曩	nẵng,nãng
黣	mỗi
設	thiết
糧	lương
牯	cổ
檑	lôi
髁	khỏa,khõa
樣	dạng
蚄	phương
闿	khai,khải
纓	anh
爕	tiếp
腏	chuyết
剢	trác
堃	khôn
隖	ổ
柚	dữu,trục
栵	lệ,liệt
埲	bồng,phủng
它	xà,đà,tha
矍	quắc
矮	oải,ải,nụy
溞	tao
蟪	huệ
丐	cái
逢	bồng,phùng
鲔	vị,vĩ
橚	thu,túc
欠	khiếm
楪	điệp
蟹	giải
燈	đăng
繈	cưỡng
妪	ủ,ẩu
媟	tá,tiết,tiếp
雴	lập
麌	ngu,vy
漨	bồng
税	thối,thoát,thuế
樨	tê
緸	nhân
瑇	đại
柟	nam
铆	mão
筒	đồng,động
馂	tuấn
袖	tụ
葹	thi
芭	ba
港	cảng,hống
蓴	thuần
拥	ủng,ung
頽	đồi
箠	chủy
載	tải,tái,tại
畸	kỳ,ki,ky,cơ
灂	trạc,tiếu,trác
儼	nghiễm
拟	nghĩ
馃	qủa
隅	ngung
叧	lánh,qủa
适	quát,thích,trích,đích
傘	tản,tán
魫	chẩm
錛	bôn
鰆	xuân
涑	tâu,tốc
湞	sanh,trinh
弇	yểm,yêm
厏	trả
匃	cái
眇	miễu,diệu,miểu
柤	trở,tra
佑	hữu,hựu
虵	xà
熨	uất,úy
烰	phù,bào
龗	lung,linh
褗	yển
昳	điệt,dật,diễm
玀	la
鍠	hoàng
霐	hoằng
遱	lâu
朵	đóa
稯	tông
乑	ngâm,khâm
晰	tích
搔	tao,trảo
閵	lận
茑	điểu
妲	đán,đát
扅	di
缣	kiêm
皐	cao
莪	nga
儜	ninh
范	phạm
駸	xâm
膜	mạc,mô
怿	dịch
籮	la
鯡	phi
仃	đính,đinh
惣	tổng
刖	nguyệt,ngoạt
緱	câu
诤	tranh,tránh
昞	bỉnh,bính
晨	thần
扮	phẫn,phạn,biện,ban,bán
工	công
蟇	mạc
岡	cương
餀	hải
蚴	u
忏	thiên,sám
槅	cách,hạch
鸊	tịch
柿	thị,sĩ
潝	hấp
踯	trịch
殻	xác
巻	quyển
婀	a,ả
僕	bộc
屙	kha,ố,a
朳	bát
赫	hách
覔	mịch
睢	huy,thư,tuy
粑	ba
办	biện,bạn
樚	lộc
徑	kính
蚓	dẫn
场	tràng,trường
繵	triền
檥	nghị,nghi,nghĩ
擤	tỉnh,hanh
榇	thấn,sấn
鷁	nghịch
脯	bô,phủ
牸	tự
辧	biện
碸	phong
停	đình
菩	phụ,bồ,bội
巂	huê,tây
絺	hy,hi
迢	điều,thiều
嫮	hộ
案	án
臑	noãn,nhi,nộn,nê,nhu,nao,nạo
觠	quyền
铕	hữu
洌	liệt
詐	trá
謷	ngạo,ngao
奉	bổng,phụng
禬	quái
勮	kịch,cự
常	thường
氏	thị,chi
凌	lăng
閾	vực,quắc
淄	truy,chuy,tri
顋	tai
滀	súc
僝	sàn,sạn
侻	thoát,đoái
估	cổ
蓽	tất
敹	liêu
蹬	đặng,đăng
屖	tê
岿	khuy,vị
鏺	bạt,bát
汔	khất,ngật
鉆	kiềm,siêm
鉶	hình
葠	sâm
飩	đồn
傎	điên
猵	biên,biển
擋	đáng,đảng
隃	dao,du
媼	ảo
蕍	du
驮	đạ,đà
鄕	hướng,hương
鈰	thị
诛	tru
谆	truân,chuân
帹	sáp,thiếp
氬	á
識	chí,thức
暆	di
骡	loa,la
淼	diểu,diễu,miểu
愤	phẫn,phấn
忔	hật,ngật
髅	lâu
頟	ngạch
虓	khiêu,hao
桌	trác
吒	trá,tra
仝	đồng
菏	hà
孩	hài
賭	đổ
瓿	bẫu,phẫu
钙	cái
纫	nhận,nhân
簳	cán
嘲	trào
盾	my,thuẫn
藼	huyên
梯	thê
顨	tốn
硕	thạc
瑱	chấn,trấn,thiến,điền
杼	thữ,trữ,thự,thư
響	hưởng
僑	kiều
吼	hống
丮	kịch
椓	trạc,trác
鳛	tập
褡	áp,đáp
稚	trĩ
蠜	phàn
糢	mô
萼	ngạc
斝	giả
𥿎	uyển
午	ngọ
碙	cương,nạo
腚	đĩnh
讱	nhẫn
螇	hề
檸	ninh,nịnh
挫	tỏa
喵	miêu
伸	thân
褺	điệp
磚	chuyên
飓	cụ
诣	nghệ
讽	phúng
溧	lật
应	ưng,ứng
娜	na,nả,nã
焦	tiêu,tiều
劾	hặc
芹	cần
髫	điều,thiều
滒	ca
龡	xuy,xúy
爝	tước
耬	lâu
似	tựa,tự
澳	úc,áo
索	sách,tác
祂	tha
关	quan,loan,tiếu
猱	nhu,nao
凇	tùng,tung
鏢	tiêu,phiêu
磗	chuyên
合	hiệp,cáp,hợp,hạp
额	ngạch
祲	tẩm
恲	phanh
鲀	đồn
扡	thiên,tha
櫌	ưu
嬌	kiều
抿	mân
鼦	điêu
葭	hà,gia
篿	đoàn
鍧	hoanh,oanh
縵	mạn,man
诖	quái
蜋	lang
些	ta,tá
罾	tăng
投	đầu,đậu
冽	liệt
侎	mị
胗	truân,chân,chẩn
龕	khám,kham
瀟	tiêu
鬨	hạng,hống
謅	xảo,sảo,sưu
姽	qủy
螸	du
漱	sấu,thấu,tâu
洣	mễ
擩	nhuyên,nhũ,nhụ
汐	tịch
鵟	cuồng
觭	kỳ,khi,ky,cơ
嶺	lãnh,lĩnh
荼	đồ,gia
胎	thai
蘽	lũy
鸜	cù
癠	tễ
馗	qùy
姱	khoa
嵘	vanh
萐	tiệp
唇	chấn,thần
骍	tinh,tuynh
档	đáng,đương
燻	huân
歀	khoản
饟	hướng
吡	phỉ,tật
仯	sáo
忺	hiêm
镕	dong,dung
鸬	lô
鳣	chiên,thiện,triên
雳	lịch
奝	điêu
攵	phộc,phốc,phác,truy
檀	đàn
笛	địch
蚘	hồi,vưu
摕	đế
腊	tích,tịch,lạp
蓂	minh
俓	kính
稠	trù,điệu,điều
詁	hỗ,cổ
偞	diệp
塽	sảng
淴	ốt,hốt
筧	kiển
鵶	nha
卓	trác
砉	hoạch
模	mô
畹	uyển
犏	biên,thiên
洴	bình
綹	lữu
獬	giải,hải
丅	hạ
鋒	phong
镥	lỗ
颯	táp
尾	vĩ
笪	đát
辝	từ
檠	kình,kềnh,kính
锻	đoạn,đoán,đoàn
耍	sá,xọa,sái,sọa
冫	băng
輴	xuân
蘚	tiển
憑	bẵng,bằng
幄	ác
硍	khẳng,hạn,khẩn
汊	xá,sá
矛	mâu
鐒	lao
怤	phu,phô
赗	phúng
块	khối
隣	lân
醛	thuyên,triết
跒	kha,khả
蚟	vương
偊	chủ,vũ,củ
箦	trách
泓	hoằng
藕	ngẫu
貝	bối
勩	duệ
蒎	phái
鮻	toa
妥	thỏa
凑	thấu,tấu
亂	loạn
玲	linh
簰	bài
羂	quyến,quyên,quyển
赨	đồng,dung
熭	duệ
鳲	thi
惙	chuyết,xuyết
鹡	tích
棲	tê,thê
彭	bàng,bành,bang
萷	tiêu
麸	phu
厵	nguyên
鐻	cự,cừ,cứ
脢	môi
濩	hoạch
𠾀	triệt
廎	khoanh,khoảnh
衬	sấn
忪	chung
灞	bá
纎	tiêm
橡	tượng
乜	mị,mã,khiết
缠	triền
柁	đà,đả
祉	chỉ
榖	cốc
仌	băng
鰨	tháp
攣	luyến,luyên
妗	cấm
貤	di,dị
嗑	hạp
髥	nhiêm
犄	cơ,ỷ
擏	kình,cảnh
蝎	hiết,yết,hạt
氚	xuyên
玂	kỳ
拑	kiềm
佀	tự
朕	trẫm
耏	nại,nhi
姐	thư,tả
薇	vy,vi
摮	ngao
榆	du
扇	phiến,thiên
劍	kiếm
卻	khước
蹍	chiển,niễn,triển
駹	mang
詖	bí
錘	chuy,chùy,chúy
钭	đẩu
幹	can,cán,hàn
醍	đề,thể
閲	duyệt
芟	sam
匒	đáp
蠧	đố
挡	đáng,đảng
么	yêu,ma
箌	trạo,tráo
劻	khuông
㕡	hác
祏	thạch
涊	niễn
軧	để
肴	hào
睨	nghễ
鸟	điểu
絏	tiết
豴	đích
冠	quan,quán
媖	anh
夣	mộng
爯	xưng
坲	phật
駔	tổ,tảng
鏮	khang
劀	quất
膾	khoái,quái
潯	tầm
笨	bổn,bản,bát
蜄	chấn
椏	nha
莙	quân,quẫn
氮	đạm
箕	cơ,ki,ky
碪	châm
彬	bân
劵	quyển
厲	lệ,lại
妁	chước
隲	chất
餹	đường
囮	ngoa
幻	huyễn,ảo
棳	xuyết
譥	khiếu
槇	điên
洞	đỗng,động
鬆	tung,tùng,tông
酩	mính
饥	cơ,ki,ky
弧	hồ,ô,o
岅	phản
笈	cấp
鞜	tháp
涣	hoán
锾	hoàn
膆	tố
螿	tương
搁	các
讙	huyên,hoan,hoán
谡	tắc
凛	lẫm
邷	ngõa
梖	bái
诘	cật
栝	quát,thiến,thiệm
岞	trách
雉	trĩ
銋	nhâm
迅	tấn
誩	cạnh
簻	qua
头	đầu
湡	ngu
頰	giáp
瘥	ta,sái
襴	lan
馋	sàm
椆	chu
幈	bình
魛	đao
砀	đãng,nãng,nương
檉	sanh
赶	cản
黷	độc
祡	sài
霤	lựu
籥	dược,thược
恂	tuân,tuấn
愕	ngạc
囌	tô
怯	khiếp
櫞	duyên
愞	nhuyễn
燒	thiếu,thiêu
耻	sỉ
赖	lại
欒	loan
柧	cô
轙	nghĩ
蘉	mang
甆	từ
队	đội
仨	ta
麕	quân,quần,khuân
皛	hiểu,hịch
臷	thiết
岪	phất,phật
宜	nghi
銅	đồng
錏	á,a
饫	ốc,ứ
漎	tủng,tùng,tung
偠	yểu
辚	lân
騍	khỏa,khóa
喥	đạc
戕	tường
惻	trắc
窹	ngụ
瑳	tha
轥	lận
護	hộ
歰	sáp
鞄	bào,bạc
朖	lãng
庬	bàng,mang
鳞	lân
輵	át,cát
冄	nhiễm
着	hồ,trứ,trước,trữ
霍	quắc,hoắc
霖	lâm
見	kiến,hiện
璃	ly,li,lê
惨	thảm
掱	vát,thủ
城	thành,giàm
塤	huân
玊	túc
館	quán
霁	tế,tễ
現	hiện
跇	sế
哙	khoái
綃	tiêu
閃	thiểm,siểm
驚	kinh
迨	đãi
诡	qủy,ngụy
擱	các
鐅	phiết
砩	phất,phế
嶡	quyết
絿	cầu
津	tân
抔	bồi,phầu
韍	phất
憐	lân,liên
篹	toản,soạn,toán
涅	niết,nát
釰	nhật
訔	ngân
佅	mại
肇	triệu
嗤	xi,xuy,si
殺	ái,sái,sát,tát
路	lạc,lộ
貺	huống
俑	thông,dõng,dũng
撲	phốc,phác,bạc
稿	cảo
檿	yểm
蠸	quyền
鱋	khư
剄	kinh,hĩnh
显	hiển
觷	hạc
爷	da,gia
驊	hoa
氘	đao
饹	lạc
臇	tuyến
颗	khỏa
鎢	ô
啐	thối,tối,ngạt,tát
尖	tiêm
涸	hạc
雒	lạc
眶	khuông
寊	trinh
闻	vặn,vấn,văn
骨	cốt
饅	man
瘅	đan,đản
濼	bạc,lạc
莃	hy
屛	phanh,bình,bính
樑	lương
埼	kỳ
黿	nguyên,ngoan
樸	phác,bốc
斐	phỉ,phi
蓲	âu
荠	tề,tể
緑	lục
偯	ai,ỷ
娈	luyến
儓	đại,thải,đài
跿	đồ
稱	xứng,xưng
沔	miện,miễn
茆	mao,mão,lữu
囔	nang
靳	cận
麽	yêu,ma
㓡	phủ
貛	hoan
蠮	yết,ế
跆	đài
跋	bạt
衾	khâm
迶	hữu
垡	phạt,phiệt
榤	kiệt
饁	diệp,ấp
咳	khái,hài
踰	du,dũ
疝	sán
賦	phú
硇	lỗ,nạo,nao
持	trì
惩	trừng
捭	phách,bác,bãi
懥	chí,sý,sí
竿	can,cán
蟛	bành
痳	lâm
鵞	nga
值	trị
诹	tưu
窔	yếu,yểu,diểu
癙	thử
阎	diêm
盪	đãng
糠	khang
癖	phích,tích
騠	đề
玁	hiểm
臍	tề
赣	cống,cám
札	trát
亹	vỉ,môn,mên,vĩ
蔥	thông
頊	húc
韦	vy,vi
擧	cử
佚	điệt,dật
徜	thảng
伕	phu
泄	duệ,tiết
睽	qúy,khuê
孢	bào
蝟	vị
乳	nhũ
濎	đỉnh
訢	hy,hi,hân
唝	cống
𢠢	ủy
楎	huy,hồn
槃	bàn
竘	cú
弓	cung
斆	giáo,hiệu
灾	tai
階	giai
歿	một
鎄	ai
诪	trù
巇	hy,hi
鋜	trạc
龣	giác
峱	nạo,nao
秽	uế
绊	bán,bạn
蓏	lõa,lỏa
夔	qùy
臡	nê
讚	tán
覷	kiến,thứ
棫	vực
藨	biễu,biều
烙	lạc
穌	tô
透	thấu
譅	sáp
尿	niếu,niệu,tuy
駻	hãn
鰳	lặc
汚	ố,ô
宸	thần
剰	thặng,thừa
剥	bác
厪	cần,cận
瑢	dung
耶	tà,da,gia
嘀	đích,đê
茔	doanh,oanh
碧	bích
宰	tể
鬾	kỵ
謁	yết
蚪	đẩu
壍	tiệm
翰	hàn
灖	mị
焄	huân,hôn
誣	vu
倴	bôn
胼	biền
鑤	bào
泱	ưởng,ương,anh,áng
嗚	ô
遑	hoàng
墋	sẩm
鉚	mão
鬫	hảm,hám
憿	kiêu
侯	hậu,hầu
穹	khung
葛	cát
閼	át,yên
垖	đôi
罨	yểm,ấp
鋸	cư,cứ
椶	tông
洺	danh,minh
簞	đan
瑯	lang
犁	lê
稽	khể,kê
杖	tráng,trượng
亩	mẫu
篞	niết
翙	kiều,hối
撄	oanh,anh
賓	thấn,tân
渢	phùng,phong
护	hộ
銦	nhân
痧	sa
蟶	sanh
爺	da,gia
陻	nhân
涵	hàm,hám
讨	thảo
瞆	qúy
閶	xương
彛	di
摆	bãi,bài,bi
嫚	oan,mạn
綧	chuẩn
圄	ngữ
轟	hoanh,oanh
愘	khác
咕	cô
潄	sấu,thấu
疉	điệp
憮	hủ,vũ
髙	cao
餯	hối
爦	lãm
萩	thu
枊	ngang
峌	điệt
芣	phù
秏	hạo,háo
錣	chuyết
旖	y,ỷ
彡	sam,tiệm
乃	ái,nãi
駜	bật
樒	mật
種	chủng,chúng
鯁	cánh,ngạnh
鍊	luyện
劄	tráp,trát
摰	chí,nghiệt
毐	ải
蚝	hào,thứ
援	viên,viện
陝	xiểm,thiểm,hiệp
頜	cáp,hàm,hạp
镐	hạo,cảo
嫟	nật
懧	nọa
灊	tiềm
氛	phân
瘸	qua
勉	mẫn,miễn
纮	hoành
櫩	diêm
沥	lịch
央	ương
岫	tụ
婤	chu
跲	kiếp,cáp,cấp
濦	hấp,ân
俋	ấp
顷	khuynh,khuể,khoảnh
謕	đề
緾	triền
喊	hảm,hám
啬	sắc
稗	bại
魔	ma
蠥	nghiệt
喃	nam
孒	củng,quyết
鑥	lỗ
聦	thông
鰉	hoàng
把	bả,bá,bà
蝲	lạt
抑	ức
澶	thiền,đạn
艸	thảo
坐	tọa
毕	tất
卢	lư,lô
觖	quyết,khụy
袱	phục
兢	căng
韗	vận
缾	bình
毿	tam
朂	húc
鹂	ly,li
蝕	thực
蘖	nghiệt,bách
屟	tiệp
芸	vân
摇	dao,diêu
醄	đào
嫘	luy
箆	bề,tỵ
鼗	đào
淀	điện,điến
醕	thuần
騙	phiến,biển
枏	nam
棷	trâu
向	hưởng,hướng
亍	xúc,súc
庣	thiêu
魭	nguyên
蟼	kỉnh
莐	trầm
咠	thấp
揜	yểm
懍	lẫm
殴	ấu,ẩu
钹	bạt
示	kỳ,kì,thị
鱑	hoàng
飈	biểu
獁	mã
㹱	xúc,thước
囟	tín
噌	tăng
稈	cán
旌	tinh
鈍	độn
车	xa
錔	tháp,thạp
猴	hầu
俟	sĩ
峽	hiệp,hạp,giáp
癈	phế
罶	lữu
贖	thục
祃	mạ
咿	y
岵	hỗ
搢	tấn
爮	bào
跃	dược
猡	la
鳆	phục
煲	bao,bảo
楄	biên,biền
佾	dật
鞵	hài
攺	cải
稘	ky,cơ,kỳ
睆	hoản,hoãn
鸧	thương
髀	bễ
攃	thát
艹	thảo
擐	hoàn,hoạn
懰	lữu,lưu
櫆	khôi
牡	mẫu
谏	gián
洮	dao,đào,thao,diêu
垌	đồng,dũng
緂	điềm
脟	luyến,liệt
卆	thốt,tốt
榅	ốt,ôn,uấn
沮	trở,thư,tư,tự
浆	tương
𤫎	oánh
独	độc
潠	tuyển,tốn
橉	lân
矱	hoạch
諕	hào,hách
頹	đồi
膺	ưng
穻	vũ,hu
嚶	anh
骶	để
鸺	hưu
藺	lận
宻	mật
墦	phiền
瘢	ban,bàn
捈	đồ
扉	phi
扔	nhận,nhưng
碄	lâm
鉕	phả
氋	mông
鼿	ngột
贱	tiện
崤	hào,yêm
贔	bí
耙	ba,bá,bà
滏	phũ,phủ
鹺	ta
熠	dập,tập
簜	đãng
荻	địch
幽	u
哒	đát
蜛	cư
嫈	oanh
渨	úy,ôi
樧	sát
愴	sang,sảng
恻	trắc
歘	hốt
吟	ngâm
沖	xung,trùng
钰	ngọc
哭	khốc
煕	hy,hi
虐	ngược
恊	hiệp
褠	câu
盃	bôi
倏	thúc
甔	đàm
潴	trư,rư,chư
飯	phạn,phãn
漿	tương
为	vị,vy,vi
唊	khiểm,giáp
窑	dao,diêu
岂	khởi,khỉ,khải
蜘	tri
腡	loa
犅	cương
台	thai,di,đài
卺	cẩn
匉	phanh
瑞	thụy
亅	quyết
泛	phiếm,phủng
虏	lỗ
盼	phiến,phán,miện
撟	kiểu,kiệu,kiều
钽	đán
镻	điệt
暇	hạ,xuyết
纷	phân
撴	đôn
𪇄	cấu
淂	đắc
弼	bật
壿	chung
嵏	tông
迊	nghinh,tạp,nghênh,táp
赥	hức
阍	hôn
他	đà,tha
獵	liệp,lạp
盷	điền
鼯	ngô
謯	trở,trớ
㶿	bột
破	phá
獐	chương
謾	mạn,man
裘	cầu,cừu
滉	hoảng
轆	lộc
钺	việt
拝	bái
暭	hạo
駮	bác
鮶	quân
缵	toản
腲	ủy,ổi
愁	sầu
坞	ổ
晗	hàm
巊	anh
袵	nhẫm
尓	nhĩ
剨	hoạch,lưu,họa
漂	xiếu,phiếu,phiêu
琰	diễm
垄	lũng
瞂	phạt
縳	truyện
碨	ôi
脁	thiếu,thiểu
齎	tê,tư
啧	sách,trách
溍	tấn
砝	kiếp,pháp
蚱	trách
繻	nhu
蠎	mãng
臥	ngọa
緅	tưu
召	chiêu,triệu,thiệu
堉	dục
兜	đâu
鄮	mậu
扊	diễm,diệm
翿	đạo,đào
衅	hấn
糹	mịch
浹	giáp,tiếp
悫	khác
坕	kinh
逌	do,du
鼛	đào,cao
峤	kiêu,kiệu,kiều
欑	toàn,toản
藉	tạ,tá,tịch
沝	chủy
導	đạo
霰	tản,tán
肱	quăng
蹮	tiên
谹	hoành
攝	nhiếp
泰	thái
蹛	trệ
鬬	đấu
貙	sơ,khu
馳	trì
绞	hào,giảo
飗	lưu
橙	đắng,chanh,sập,tranh
蚁	nghĩ
戞	kiết
竸	cạnh
諸	gia,chư
幃	vy,vi
覈	hạch
佣	dong,dụng,dung
戎	nhung
灚	giảo
蘀	thác
両	lạng,lưỡng,lượng
卖	mại
拸	trì
闞	hám,khám,hảm,giảm
秄	tử
搖	dao,diêu
漑	khái,cái
吥	bất
聀	chức
咊	hòa
簾	liêm
錆	thương
舲	linh
麪	miến
豋	đăng
颻	dao,diêu
詪	ngận
恡	lận
鬣	liệp
庋	qủy,kĩ,kỹ
譬	thí
翷	lân
擓	khối
韪	vĩ
砌	thế,xế
葇	nhu
躏	lận
柅	ni,sí
幨	siểm,xiêm,siêm
轩	hiên
框	khuông
咐	phó,phù
厦	hạ
磹	điệm
誘	dụ
暍	hát,yết
鉢	bát
挥	huy
蹔	tạm
邙	mang
麫	miến
茛	cấn
訹	tuất
祺	kỳ,kì
霭	ái,ải
攻	công
縊	ải
溏	đường
抠	khu
銃	súng
聋	lung
纛	đạo,độc
悰	tông
骣	sạn
艤	nghĩ
餕	tuấn
発	phát
僐	thiện
甐	lân
圏	khuyên,quyển
铉	huyễn
哢	lộng
鰻	man
俘	phu
时	thời,thì
靾	duệ,dị
镬	hoạch
願	nguyện
戳	trốc,trạc,sác
醱	phát,bát
覸	gián
踕	tiệp
獏	mạc,mô
焊	hạn,hãn
礿	dược,thược
姦	gian
晬	tối
远	viễn,viến
縉	tấn
蠕	nhuyễn,nhu
稴	liêm
败	bại
纍	lũy,luy,lụy
养	dưỡng,dượng,dường,dạng
磶	tích
艆	lang
孑	quyết,kiết
旰	cán,hãn
軏	nguyệt,ngột
鸇	chiên
窢	vực
精	tinh
顀	trùy
抴	duệ
覺	giáo,giác
更	cánh,canh
喑	âm,ấm
蘥	dược
羠	di
氤	nhân
譀	hám
承	tặng,chửng,thừa
軹	chỉ
腰	yêu
茓	huyệt
譯	dịch
蒽	ân
绁	tiết
鞦	thu
隻	chích
懂	đổng
斕	lan
菊	cúc
齟	trở,thư
恜	sức
胺	át
櫸	cử
鰍	thu
逍	tiêu
缈	diểu,miểu
羝	đê
袣	duệ
镌	tuyên
蓶	dụy
扐	lặc
镚	băng
纴	nhâm
罹	duy,ly,li
覉	ky,ki
伞	tản,tán
渺	diểu,miểu,diêu
芍	thược
动	động
少	thiếu,thiểu
丽	lệ,ly
褛	lũ
锂	lý
蹄	đề
觑	thứ
卍	vạn
澧	lễ
莽	mãng
岊	tiết
巴	ba
涇	kinh,kính
崃	lai
軲	cô
圖	đồ
賂	lộ
黡	yểm
龀	sấn
揵	kiện,kiền
槊	sóc,sáo
蕆	sản,siển,xiển
呻	thân,hạp
靥	yểm,yếp
縕	ôn,uẩn,uân
陜	xiểm,thiểm,hiệp
觝	để
軻	kha
陣	trận
譑	kiểu
轈	sào
討	thảo
尟	tiển
铜	đồng
膓	tràng,trường
婎	huy
扂	điếm,điệm
芽	nha
馍	mô,ma
蠔	hào
遁	tuần,độn,thuân
櫛	trất
虢	quắc,quách
晤	ngộ
划	hoạch,hoa,qủa,họa
縰	ly,sỉ,sái
魊	vực
硬	ngạnh
憗	ngận
蹼	phốc,bốc
锒	lang
掣	sế,xế,xiết
靼	đát
餠	bính
羢	nhung
悁	quyến,quyên
鸌	oách
莩	phu,biễu,biểu
嘔	hú,ẩu,âu,hu
许	hử,hứa,hổ
荑	đề,di
鬐	kỳ,kì
狍	bào
毰	bồi
啜	xuyết
𠁷	sản
曳	duệ
蟣	kỉ,kì,kỷ,kỳ
牾	ngộ,ngỗ
茘	lệ
睍	hiện,hiển
罅	há
圭	khuê
綸	quan,luân
輧	bình
蜳	đôn
摠	tổng
揲	diệp,xà,thiệt,điệp
返	phiên,phản
溮	sư
歼	tiêm
鮌	cổn
埜	dã
縍	bàng
涼	lương,lượng
珀	phách
锈	tú
裧	xiêm
儢	lữ
鄣	chướng,chương
濘	nính,nịnh
蠑	vinh
饞	sàm
猻	tôn
状	trạng
鴓	bật
腺	tuyến
緷	hồn,vận
妯	trừu,trục
瓬	phưởng
忑	đảo,thắc
獴	mông
甁	bình
荍	kiều
卷	quyến,quyền,quyển
瑤	dao
犈	quyền
厴	áp
纠	kiểu,củ
觻	lộc
刧	kiếp
铴	thảng
艫	lô
乔	kiều
镺	áo
呲	thử
礆	dảm,kiềm,thiêm
佩	bội
轴	trục
簑	thoa,xoa
刉	ky
崛	quật
曉	hiểu
鈼	tạc
蜨	điệp
耆	kỳ,kì,thị,chỉ
鵠	hộc,cốc
耘	vân
晏	án,yến
監	giám,giam
戲	huy,hi,hô,hí,hý
帚	trửu,chửu
慽	thích
乀	phất,phật
赍	tê
龜	quy,quân,khưu,cưu
悢	lãng,lượng
謹	cẩn
祿	lục,lộc
贅	chuế
薦	tiến,tấn,trãi
蕸	hà
訐	yết,kiết
嵒	nham
笙	sanh,sinh
箘	duẩn,khuân
瘟	ôn
兖	duyện,duyễn
撒	tản,tát
蠃	loa,lõa,lỏa
籯	doanh
閔	mẫn
琁	toàn,quỳnh,tuyền
贓	tang
枣	táo,tảo
呶	nao
牚	sanh
襊	toát
贇	uân
罽	kế
鳝	thiện
晈	hiểu
识	chí,thức
鰼	tập
嶟	tôn
猝	thốt
穑	sắc
圠	át
噳	ngu
阯	chỉ
砧	châm
诌	sưu,sảo
鹹	hàm,giảm
减	giảm
鮪	vị,vĩ
烝	chưng,chứng
糵	nghiệt
端	đoan
岱	đại
脖	bột
醯	ê,hề
辐	bức,phúc
漪	y
卒	thốt,tuất,tốt
綵	thể,thái,thải
膊	bác,bạc
閙	náo,nháo
畱	lưu
醨	ly,li
恐	khúng,khủng
阖	hạp
碞	nham
悍	hãn
轫	nhận
蓐	nhục
卮	chi
鋕	chí
輊	chí
裯	chù,trù,đao
协	hiệp
讲	giảng
浈	trinh
混	côn,hồn,hỗn,cổn
锸	tráp
入	nhập
齚	sạ,trách
巳	tị,tỵ
蹏	đề
虽	tuy
薀	ôn,uẩn
钸	bố
燹	tiển
欄	lan
探	thám,tham
犌	gia
氎	điệp
囤	độn,đồn
哞	mâu
榬	viên
曄	diệp
喤	hoàng
铸	chú
忭	biện
玄	huyền
肥	phì
蕉	tiêu
弸	băng,bằng
铞	điếu
檝	tiếp
酲	trình
挅	sủy,đỏa,tuy
迟	trí,khích,trì
蔬	sơ
琮	tông
歎	thán
潢	hoàng,hoảng
匓	cứu
鈚	phê
细	tế
孨	chuyển
狽	bái
飾	sức
咷	đào
鰌	thu,tù
闸	sạp,áp
瞇	mị
玱	thương
蓱	bình
盅	trung,chung
鶼	kiêm
顠	phiếu
簮	trâm
羇	ky,ki
鐮	liêm
量	lương,lường,lượng
狑	linh
绨	đề
籢	liêm
芾	phất,phí
酡	đà
叻	lặc
笴	hạo,khả
恙	dạng
楟	đình
偷	thâu,du
羡	tiện,di
沋	vưu
滭	tất
円	viên
恅	lão
搴	khiên
伱	nhĩ,nễ
汨	duật,cốt,mịch
鉊	chiêu
剩	thặng
溥	phu,phổ,bạc
搉	giác,xác
伋	cấp
鏝	man
美	mĩ,mỹ
睔	cổn
播	bả,bá
瓞	điệt
掐	kháp
创	sáng,sang
付	phó,phụ
萎	nuy,uy,ủy
蠢	xuẩn
灑	tẩy,sái,si
滪	dự
甒	vũ
毚	sàm
抯	tra
郓	vận
編	biên
彏	cược,quặc
粇	canh
昂	ngang
唳	lệ
属	thuộc,chú,chúc
囡	niếp,nam
飵	tộ
里	lí,lý
罣	khuể,quái
璽	tỷ,tỉ
藚	tục,độc
瘇	chủng
箱	sương,tương
濞	tý,tỵ,tị
鱠	khoái,quái
竦	tủng
腍	nhẫm
溪	hoát,khê
瀷	dực
紙	chỉ
薔	sắc,tường
繢	hội,hối
沴	lệ,diễn
闺	khuê
犨	thù,sưu
妠	nạp
釢	nãi
癒	dũ
讻	hung
垯	đáp
嘈	tào
蘁	ngạc,ngộ
餖	đậu
膦	lân,lận
乱	loạn
紥	trát
蝒	miễn
爚	dược
申	thân
驴	lư
斾	bái
噙	cầm
矠	tích
曽	tằng
肽	thái
慔	mạc
掏	đào
髽	qua,toa
瑪	mã
戈	qua
崙	luân,lôn
吿	cốc,cáo
夸	khoa,khõa
蕑	gian
齄	tra
见	kiến,hiện
攴	phộc,phốc,phác
嶜	toàn,tâm
坂	bản,phản
鬉	tùng,tông
裴	bùi,bồi
振	chấn,chân,chẩn
擰	ninh,nịnh
绹	đào
唲	oa,nhi
籃	lam
璐	lộ
辅	phụ
浔	tầm
咅	phôi,phủ
錈	quyển
鏏	duệ,vệ
襼	nghệ
巆	vanh
霄	tiêu
輢	ỷ
崄	hiểm
盞	trản
晴	tình
啼	đề
臋	đồn
矶	ky,ki
塚	trũng,trủng
沩	duy,vy
簃	di,dĩ
餛	hồn
頓	đốn
僊	tiên
咡	nhị
椉	thừa
印	ấn
鄇	hậu
丯	phong
潍	duy
鐈	kiều
粝	lệ
银	ngân
狔	nỉ
邯	hàm
您	nẫn,nâm
柠	ninh,nịnh
閴	khuých
欵	khoản
耢	lạo
庇	tý,tí
挺	đĩnh
擿	thích,trịch,trích
蚬	hiện
蛼	xa
飰	phạn,phãn
轧	ca,yết,loát
劫	kiếp
襬	bi,bãi
鉔	táp
瘓	hoán
眃	hỗn
勚	duệ
髿	ta
颲	liệt
仏	phật
陷	hãm
窝	oa
壚	lự,lư,lô
斁	đố,dịch
笒	linh
澀	sáp
饨	đồn
蟖	tư
硚	kiều
鵙	quyết
儴	nhương
諔	xúc,tịch
鏁	tỏa
鬙	tăng
穥	dự
珤	bảo
縻	my,mi
袗	chân,chẩn
確	xác
姏	kiềm
神	thần
疊	điệp
糷	lan
恭	cung
秞	dứu
髖	khoan
鎤	hoảng
肭	nạp,nột
贞	trinh
秬	cự
俭	kiệm
硏	nghiên,nghiễn
嘻	hy,hi
遌	ngạc,ngộ
蟮	thiện
瘪	biết,biệt,tất
炨	xuy
各	các
捡	kiểm
派	ba,phái
験	nghiệm
詎	cự
墾	khẩn
谂	thẩm
紳	thân
詻	ách,ngạch
勃	bột
侩	khoái,quái
摊	than
沽	cô,cổ
黾	mãnh,mẫn
枢	xu
骇	hãi
沵	lệ
穟	tuệ,toại
寚	bảo
揹	bội
拖	đà,tha
俙	hy
謠	dao
黨	chưởng,đảng
溽	nhục
眈	đam
枴	quải
鞡	lạp
那	na,nả,ná
饘	chiên
蕢	qũy,khoái
針	trâm,châm
墄	thức
鮆	tễ
恉	chỉ
鴇	bảo
换	hoán
鬯	sưởng
姻	nhân
残	tàn
牲	sinh
獮	tiển
冀	ký,kí
肆	thích,tứ,dị
湔	tiền,tiễn,tiên
晛	hiện
鵒	dục
妉	đam
嘘	hư
巍	nguy
渑	mẫn,thằng,miễn
駿	tuấn
馺	táp
鹧	giá,chá,gia
鍋	oa
烟	yên,nhân
冬	đông
鎪	sưu
跌	điệt,trật
茴	hồi
綴	chuế,chuyết,xuyết
汝	nhữ
媧	oa
謑	hệ
鐹	qủa
詠	vịnh
会	cối,hội
齅	khứu
閿	văn
疆	cương
呗	bối,bái
箯	tiên
蜸	khẩn
飼	tự
螎	qủa,dung
帱	đào,trù
幋	bàn
聿	duật
貃	mạch
的	đích,để
籼	tiên
鹒	canh
衪	dị
紉	nhận,nhân
坌	phần,bộn
噉	đạm,hám
没	một
瓈	ly,li,lê
鮝	tưởng
鏛	thường
鞀	đào
賸	thứng,thặng
禨	ky,kỵ
綱	cương
濴	oanh,huỳnh
阅	duyệt
懟	trụy,đỗi
螂	lang
賠	bồi
秅	nà,trà
豕	thỉ
噜	lỗ,rô
琚	cư
泋	húy
嘂	khiếu
哜	tế,tễ
涤	địch
垸	hoàn,viện
嗃	hao,hạc,háo
縯	diễn
襍	tập,tạp
曣	yến
續	tục
鍀	đắc
絀	chuyết,truất
攜	huê
茎	hành
鰐	ngạc
苣	cự
鯾	tiên
颖	dĩnh
瀜	dong,dụng,dung
皇	hoàng
晅	huyên
驰	trì
緘	giam
涖	lị
嘴	chủy
滯	trệ
羍	thát
忲	thái
鯀	cổn
蜕	thuế
敪	uyết,xuyết
鎌	liêm
紛	phân
塔	tháp,đáp
莠	dữu,tú,dửu
穈	my,môn
葆	bảo
傒	hề,hễ
瘊	hầu
䎬	bá
舃	tích
躡	niếp,nhiếp
胬	nỗ
忨	uyển,ngoan
现	hiện
缝	phúng,phùng
嘖	sách,trách
買	mãi
迮	trách
遜	tốn
奭	thích
鑴	huê
蚻	trát
槼	quy
诓	cuống
绖	điệt
無	vô,mô
釴	dặc
蛟	giao
缡	sỉ,ly,li,sái
樘	sanh,đường
昋	huệ
讵	cự
珷	vũ
塉	tích
辁	thuyên
瞠	sanh
掠	lược
秕	bỉ,tỷ
茍	cức,cẩu
麠	canh
俯	phủ
榘	củ
斻	hàng
枇	tì,tỳ
桬	sa
暋	mân,mẫn
紐	nựu,nữu
玻	pha
爥	chúc
霿	mộng,mậu
澴	hoàn
软	nhuyễn
胊	cù
熏	huân
殛	cức
鎒	nậu
陪	bồi
娿	a,ả
肧	phôi
鏕	ao
噩	ngạc
搛	kiêm
笵	phạm
茫	mang
厕	trắc,xí
弝	bá
渖	thẩm
傻	sỏa,xọa,sọa
咺	tuyển,tuyên,huyến
䐇	thần
豾	phi
狜	cổ
钓	điếu
讟	độc
鸢	diên
兟	sân
懠	tê
嶫	nghiệp
謎	mê
谘	tư,ti
盳	manh
粕	phách
腇	nỗi
阗	điền
暱	nật,nặc
均	quân,vận
刂	đao
燏	uất,duật
淚	lệ,lụy
獄	ngục
赬	sanh,trinh,xanh
攩	đảng
灴	hồng
瘴	chướng
笃	đốc
畞	mẫu
邝	quảng
叽	ky,kỉ,cơ
摝	lộc
畛	chẩn
蕴	ôn,uẩn,uấn
幣	tệ
运	vận
鐂	lưu
巹	cẩn
奂	hoán
骝	lưu
磓	đôi
刅	sang
骏	tuấn
禕	y
蜥	tích
儹	toản
剔	dịch,thế
媚	mị
厞	phi
鮑	bão,bào,bảo
堭	hoàng
啽	ngàm
吋	thốn,đẩu
辶	sước
洇	yên,nhân
氡	đông
偫	trĩ
觟	khỏa
竫	tĩnh
榩	kiền
咋	trá,trách
痗	mội,một,mỗi
濆	phún,phẫn,phần
蚷	cự
烁	thước
輥	cổn
断	đoạn,đoán
籣	lan
橰	cao
尒	nhĩ
譓	huệ
医	y,ế
趂	sấn
辡	lạt,biện
簩	lao
鲑	khuê,hài
鼩	cù
砻	lung
痑	đả
懘	sế
弻	bật
罂	anh
盎	áng
复	phục,phúc,phú,phức
觇	chiêm,siêm
键	kiện
辥	tiết
泻	tích,tả
枹	phu,phù,bao
鐶	hoàn
选	tuyển,tuyến
梡	khoản
诚	thành
膬	sế
扈	hỗ
頠	ngỗi
楊	dương
肾	thận
紂	trụ
褣	dung
籁	lãi,lại
髮	phát,bị
畔	bạn
榻	tháp
緋	phi
搯	thao,đào
誓	thệ
仮	giá,giả
留	lưu
鐁	tư
様	dạng
毯	thảm
妹	muội
彔	lục
末	mạt
場	tràng,trường
毨	tiển
療	liệu
涞	lai
酗	hú,húng,hung
豈	khởi,khỉ,khải
縭	sỉ,ly,li,sái
攧	điên
鷙	chí
鸞	loan
髶	nhung
榜	báng,bảng
夢	mộng,mông
旣	ký,kí
昈	hộ
吻	vẫn
榯	thì
假	giá,hà,giả
癞	lại
绌	chuyết,truất
宿	túc,tú
努	nỗ
蒡	bàng,bảng
梟	kiêu
娃	oa
衍	diên,diễn
翁	ông
擞	tẩu
燄	diễm
巽	tốn
郇	hoàn,tuân
俌	phụ
蛫	qủy
柰	nại
洳	nhự,như
係	hệ
诬	vu
栂	mẫu
剠	kinh,kình,lược
蜰	phì
單	đơn,đan,thiền,thiện,đạn
閗	đấu
凉	lương,lượng
望	vọng
槻	quy
舝	hạt
旛	phan
粢	tế,tư,từ
瞲	huyết
绚	huyến
艘	tao,sưu
穅	khang
嚗	bác
咱	cha,ta,gia
羒	phân,phần
舁	dư
漴	sùng
驃	phiếu,phiêu
佉	khư
睼	đề
辕	viên
掖	dịch
斌	bân
璚	quỳnh
茱	thù
嗄	hạ,sá,a,chới
彝	di
酶	môi
冑	trụ
揦	lạt,lạp
檷	nhĩ
滔	thao,đào
错	thố,thác
骄	kiêu
攭	lệ
妮	ni
镞	thốc
逻	la
坦	thản
檽	nâu
峪	cốc,dục
趴	bát
腌	khảng,yêm
喬	kiêu,kiều
飿	đốt
踾	bức
磝	ngao
凢	phàm
礧	lôi,lỗi
檞	giải
彄	khu
虔	kiền
糞	phân,phẩn,phấn
旊	phưởng
撦	xả
馏	lựu,lưu
胖	phán,bàn
霹	phích,tích
井	đán,tỉnh,tĩnh
硡	hoành
玓	đích
惪	đức
赡	thiệm
筥	cử
绸	thao,trừu,trù
彼	bỉ
荈	suyễn,xuyễn
经	kinh
轕	cát
鹳	quán
炭	thán
螷	bảnh
椌	khoang,oản,không
鲙	khoái,quái
翏	liêu,liệu
脒	mễ
鍫	thiêu
慌	hoang,hoảng
鍮	thâu
餚	hào
拕	đà,tha
俈	khốc
哼	hanh
菟	đồ,thố,thỏ
翺	cao,ngao
酞	thái
味	vị
紬	trừu
苺	môi
蔭	âm,ấm
卦	quái
绶	thụ
婕	tiệp
唯	duy,dụy
铀	do
扰	nhiễu
勧	cần
橈	kiêu,nạo,nhiêu
氖	nãi
兆	triệu
厤	lịch
躭	đam
麷	phong
壘	lũy,luật,lỗi
妐	chung
鎡	tư
蚂	mã
躧	sỉ
紆	u,vu,hu
碯	não
霓	nghê
俕	tám
试	thí
柂	đà,di
躶	khỏa,lõa
虣	bạo
缆	lãm
莤	súc,du
铋	bí
眬	lung
孷	ly
愬	tố,sánh,sách
仛	đạc,sá
裥	giản,cán
靺	mạt
虜	lỗ
評	bình
邻	lân
甍	manh
嘧	mật
泿	ngân
绿	lục
恈	mâu
蛁	điêu
咣	quang
祊	banh
醶	nghiệm
浓	nùng
鉍	bí,tất
撅	quyết,quyệt,quệ
蠍	hiết,yết
諻	hoàng
菂	đích
鷯	liêu
批	phê
航	hàng
燎	liệu
闼	thát
欞	linh
衢	cù
瘜	tức
溅	tiễn,tiên
笰	phất
鳬	phù
誖	bội
鱣	chiên,thiện,triên
匐	bặc
耠	hoát
薳	vị,vĩ
笅	hào
炒	sao
罫	quải,quái
楹	doanh
衸	giới
蔚	uất,úy
蹦	băng,bính
璘	lân
幮	trù
助	trợ
码	mã
檰	miên
噘	quyết
誄	lụy,lỗi
张	trương,trướng
訩	hung
嗐	hại,hạt
诀	quyết
蒪	thuần
鮁	bát,phệ
喏	nhạ,nặc
榾	cốt
犺	kháng
阄	cưu
隙	khích
抉	quyết
診	chẩn
侧	trắc
墐	cận
矖	ly
堲	tức
蹤	tung
舚	thiêm
怖	phố,bố
琪	kỳ,kì
镲	sát
熱	nhiệt
扆	ỷ
佘	xà
吣	khấm
鉋	bào
輛	lạng,lượng
膈	cách
咻	hú,hủ,hưu
豀	hề,khê
滷	lỗ
痘	đậu
頣	di
缗	mân
岉	vật
蹵	xúc,thúc
鲐	thai,di
朱	châu,chu
胰	di
芠	văn
憭	liễu,liêu,liệu
襌	đan,đơn
俴	kiến,tiễn
蘅	hành,hoành
钧	quân
霣	vẫn
倐	thúc
舟	châu,chu
峴	hiện,nghiễn
鈺	ngọc
皁	tạo
嘑	hô,hố
罌	anh
咭	cật,khiết,kê
鯖	chinh,thinh
厬	qũy
湿	thấp,chập
释	thích,dịch
璠	phan
慨	khái
侞	như
槑	mai
翄	sí
傜	dao
趕	cản
鄔	ổ
犞	kiều
涧	giản
葩	ba
痙	kinh,kính
元	nguyên
绩	tích
轎	kiệu
痲	ma
皚	ngai
欸	ái,ải,ai
翦	tiễn
潮	triều,trào
鸥	âu
哔	tất
鞞	bỉ,bính
漅	sào
舻	lô
戮	lục
蚢	hàng
恓	tê,tây
锨	hân
癢	dưỡng,dương,dạng
顱	lư,lô
辔	bí
榛	trân,trăn
墖	tháp,đáp
儱	lung,lũng
丶	chủ
珃	nhiễm
顇	tụy
仲	trọng
嫵	vũ
憬	cảnh
駓	phi
赜	trách
翔	tường
澰	liễm
緎	vực
殥	dần
繹	dịch
絇	cù
爿	bản,tường
弍	nhị
企	xí
櫰	hoài
踵	chủng
閂	soan
箫	tiêu
羔	cao
謼	hô
縦	túng
腮	tai
吧	ba
簝	liêu
邦	bang
豁	hoát,khoát
蠉	huyên
烤	khảo
陨	vẫn,viên
嫫	mô
慍	uẩn,uấn
衰	suy,súy,thoa,thôi
鶠	yển
堪	kham
鈄	đẩu
秆	cán
觥	quang,quăng
艳	diễm
宓	phục,mật
撧	tuyệt,quyết
孓	củng,quyết
踐	tiễn
毌	quán
懑	muộn
縓	thuyến
瞏	quỳnh
曵	duệ
輂	cúc
掿	nạch
彥	ngạn
蒩	tô
緫	thông,tổng
裭	sỉ
鈞	quân
跭	hàng
鄗	hạo,khao
白	bạch
皵	thước
敩	giáo,hiệu
鏟	sản,sạn
惰	đọa,nọa
鼟	thăng
浤	hoành
瘞	ế
绍	thiệu
脝	hanh
鮨	qùy,nghễ
篘	trừu
萸	du
镡	thiền,tầm,đàm
蒴	sóc
耄	mạo
晌	thưởng,hướng
禓	thương,dương
鑭	lạn,lan
佖	tất
楠	nam
铧	hoa
缁	truy,tri
戱	hô,hí,huy,hý
秃	thốc,ngốc
豯	hề
黸	lô
躓	chí,trí,tri
碍	ngại
鄀	nhược
淝	phì
围	vy,vi
苡	dĩ
牦	mao,ly,li
沸	phất,phí
蹊	hề
媻	bàn
垛	đóa
簣	qũy
徹	triệt
砢	kha,lõa
厍	xá
皱	trứu
虍	hô
惮	đạn
蒯	khoái
餎	lạc
鲤	lí,lý
縴	khiên,khiến
嚷	nhượng,nhương,nhưỡng
刲	khuê
𦒟	phách
譩	y
庤	chí,trĩ
寠	lũ,cũ
堠	hậu
襥	bộc
孥	nô,noa
滄	thương
覘	chiêm,siêm
轨	qũy
癣	tiển
畜	súc,húc
莆	bồ,phủ
礮	bác,pháo
慦	ngận
醚	my,mê
棊	kỳ,kì
窴	điền
卟	kê
灤	loan
脞	thỏa,thoa,tỏa
榼	khạp,kháp
憯	thảm
鏻	lân
莂	biệt
娓	vỉ,vĩ
蚠	phân,phẫn
鯊	sa
槙	điên
裆	đương,đang
缎	đoạn
疮	sang
颛	chuyên
鞬	kiện
雝	ủng,ung
殪	ế
魃	bạt
墀	trì
槤	liên
灋	pháp
窆	biếm
欢	hoan
培	bẫu,bậu,bồi
蓯	thung
刿	quế
懫	chí
槥	tuệ
斅	hiệu
癄	tiều
厣	áp
篳	tất
蟻	nghị,nghĩ
癆	lao
弩	nỗ
胮	bàng,phang
鄊	hương
硎	hình
唆	toa
髡	khôn
掸	đàn,đạn
璵	dữ,dư
蝀	đông
帕	bạch,phách,mạt,phạ
虯	cầu
嶕	tiêu
披	phi,bia
倨	cứ
氯	lục
器	khí
穬	quáng
槐	hòe
稍	sao,sảo
晻	ám,yểm,ảm
牁	ca
埆	xác
颧	quyền
遨	ngao
釗	chiêu
鶹	lưu
鴈	nhạn
鴛	uyên
嬿	yến
訧	vưu
蝗	hoàng
珓	giảo
莿	thích
乖	quai
耑	đoan,chuyên
鑿	tao,tạc
慇	ân
礫	lịch
釀	nhưỡng
侘	sá
岥	pha
幧	thiêu
嶔	hâm,khâm
伟	vĩ
鸡	kê
銽	tiêm
毬	cầu
篗	dược,diệp
卂	tín
韻	vận
寎	kính
愣	lăng
遹	duật
疖	tiết
說	thuyết,duyệt,thoát,thuế
孡	thai
蹌	thương
芮	nhuế
娧	duyệt
匦	qũy
昉	phưởng
类	loại
塼	chuyên
掷	trịch
柜	qũy,cự,cử
臊	tao,táo
邏	la
饵	nhĩ,nhị
娱	ngu
鶿	tư
巑	tán,toản
卩	tiết
蛘	dưỡng,dạng
蜒	duyên,diên
覊	ky,ki
冻	đông,đống
黈	thẩu,thâu,chủ
嵇	kê
璸	tân
偅	chủng,động
室	thất
诟	cấu
倈	lại,lai
醢	hải
劈	phách
祑	trật
丝	ty
矦	hầu
葢	cái,hạp
塞	tái,tắc
架	giá
袊	lãnh
鼄	thù,chu
碅	khuân
啕	đào
傺	sế
脤	thận,thần
喦	nham
輹	phục,phúc,bức
億	ức
绣	tú
晋	tấn
雌	thư
穵	oạt,ấp
謘	trì
窬	du
帧	tránh
给	cấp
騖	vụ
啈	hạnh,hanh
度	độ,đạc
黅	câm
菱	lăng
綩	uyển
肌	cơ
伤	thương
箊	ư
禁	cấm,câm,cầm
耸	tủng
政	chinh,chính,chánh
泥	nệ,nễ,nê
吨	đốn
豺	sài
亭	đình
铲	sản,sạn
懻	ký
齛	tiết
剳	tráp
鉺	nhĩ,nhị
劳	lạo,lao
纰	phi,bì
题	đề
覕	miết
蕡	phí,phần
呬	hi,linh,hứ
湏	tu,hối
皆	giai
貰	thế
坋	phấn
嗞	chi,tư
碥	biển
堳	thi
馝	tất
辴	xiên,xiển
篸	trâm,sâm
鸴	hạc
缲	tao,tảo,sào
梲	chuyết,thoát
類	loại
旒	lưu
抐	nạp,nột
尧	nghiêu
栢	bách,bá
哲	triết
衒	huyễn
糗	khứu
碆	ba
憷	sở
蝖	huyên
婴	anh
籉	đài
鑷	nhiếp
虀	tê
鰣	thì
獧	quyến
葑	phúng,phong
彤	đồng
舎	xá
欹	y,khi
擁	ủng,ung
颟	man
昱	dục
蛊	cổ
赢	doanh
蜇	triết
囷	khuân
玃	quắc,quặc
旆	bái
蛏	sanh
挌	cách
蔻	khấu
猛	mãnh
踣	phấu,bặc
瑜	du
部	bẫu,bộ
鋂	môi
黦	uất
积	tích,tí
塍	thành,thăng
莑	bồng
板	bản
瞙	mạc
澖	nhàn
柨	thị,sĩ
茞	chỉ,thần
礬	phàn
顦	tiều
梂	cầu
飮	ấm,ẩm
數	xúc,sổ,số,sác
审	thẩm
龇	thử,sài
贬	biếm
鑁	tông
爸	bả,ba
獠	liêu,lão
潦	liêu,lạo,lao
繐	tuệ,huệ
轶	điệt,triệt,dật
鰒	phục
譛	trấm
嚳	khốc
瓶	bình
醑	tữ,tử
爓	diêm,kiền,diễm
圅	hàm
煗	noãn
濤	đào
濈	trấp
圞	luân,loan
魆	tuất,huất
訏	hủ,hu
誨	hối
緌	nhuy,tuy
蹇	giản,kiển
媾	cấu
褌	côn
澣	cán,hoán,hoãn
幡	phan,phiên
缂	khách
賜	tứ
顸	han
暿	hy
鸳	uyên
匚	phương
矁	thu,thiễu
籚	lư
铎	đạc
祚	tộ
谧	mật,mịch
綬	thụ
蕺	trấp
梈	phanh
踈	sơ
朮	truật
灟	chúc
蹾	đôn
邑	ấp
牺	hy,hi
樼	trân
轻	khánh,khinh
硼	phanh,bằng
珍	trân
贵	qúy
壎	huân
賞	thưởng
膌	tích
号	hào,hiệu
齈	nông
驭	ngự
魟	hồng
捥	oản,uyên
髵	nhi
膪	súy
辵	sước
擀	cán
騤	quyết,qùy
消	tiêu
纾	thư
聟	tế
装	trang
滮	bưu
罦	phù
樠	man
霞	hà
軳	bào
讂	huyến
麨	xiểu
鳟	tôn,tỗn
嚏	đế,sí
岔	xóa,sá,xá
髺	kế,quát
輶	du
众	chúng
袚	phất,bát
窗	song
昙	đàm
喧	huyên
癮	ẩn
焌	tuấn
赔	bồi
舔	thiểm
庠	tường
譟	táo
缋	hội
嚚	ngân
攈	quấn
次	thứ,tư
靧	hối
昃	trắc
铮	tranh
惹	nhạ,nha
厖	bàng,mang
囍	song hỉ,hỉ
薻	tảo
椟	độc
鸭	áp
旜	chiên
籛	tiên
硯	nghiễn
黻	phất
鮎	niềm,niêm
薾	nhĩ
坜	lịch
唤	hoán
樺	hoa
噂	tổn,tỗn
撕	ty,tê,ti,tề,tỵ
棽	sâm
巿	phất,thị
芫	nguyên,diêm
釂	tiếu
幦	mịch
剑	kiếm
秋	thu,thâu
洶	hung
歪	oa,oai
薴	ninh,trữ
逐	trục
槹	cao
萱	huyên
蹷	quyết
鼬	dứu
驺	sô
颔	hạm
仗	trượng
褵	sỉ,ly,li,sái
賀	hạ
矧	thẩn
蕰	ôn,uẩn
瑿	ê
玭	biền
阂	ngại
磲	cừ
綇	thu
痏	vị
躕	trù
瞽	cổ
授	thụ,thọ
謊	hoang
潞	lộ
簋	qũy
條	thiêu,điêu,điều
祫	hợp,hạp
鬛	liệp
母	mô,mẫu
缥	phiếu,phiêu
狫	lão,lao
哤	mang
邕	ung
濫	hạm,lam,lạm,lãm,cãm
跬	khuể
坝	bá
崼	thị
犉	nhuyên,thuần
銼	tòa,tỏa
阻	trở
驼	đà
誺	sỉ
搊	sưu,xâu,trửu,xu,sâu
枘	nhuế
緰	đầu
悳	đức
锊	luyệt
糉	tống
嫪	liệu
竺	đốc,trúc
蛖	mang
瞌	khạp,hạp
巣	sào
伛	ủ
韎	muội
笯	nô
餒	nỗi
澒	hổng,hống
权	quyền
檬	mông
鱘	tầm
蟧	liêu,lao
瘵	sái
堵	đổ
㐹	ngật
邮	bưu
忞	mân
猼	bác
聴	thính
鸰	linh
蝉	thiền,thuyền
糁	tảm
瀌	tiêu
褢	hoài
饬	sức
鉠	ương
諆	khi
餡	hãm
魉	lưỡng,lượng
賚	lãi,lại
痴	si
旳	đích
艄	sao
捏	niết
蘗	nghiệt,bách
鏥	tú
仅	cẩn,cận
酦	phát,bát
來	lãi,lai
屪	liêu
餬	hồ
原	nguyên,nguyện
鱿	vưu
窵	điếu
汁	hiệp,chấp,trấp
苔	đài
囫	hốt
陼	chử,đổ
蕃	phiên,phiền,phồn
垂	thùy
龒	long
絥	phục
瀼	nhượng,nhương,nhưỡng
鱤	cảm
鯚	qúy
甊	lậu
蠶	tằm,tàm
钳	kiềm
蕘	nhiêu,nghiêu,nhiễu
亄	ý
温	ôn,uẩn
侐	tuất,hức
仫	mu
驩	hoan
毇	hủy
眲	nhị
犛	mao,ly,li
桓	hoàn
襜	xiêm
都	đô
疥	giới
鲛	giao
瑟	sắt
玩	ngoạn
倂	tính
胂	thân
壺	hồ
崡	hàm
旄	mao,mạo
麟	lân
嬸	thẩm
纽	nựu,nữu
玏	lặc
蒧	điểm
亀	quy
枲	tỷ,tỉ
詮	thuyên
堙	nhân
吞	thôn
鯠	lai
步	bộ
鉘	thế
樲	nhị
峇	khạp
鰲	ngao
糡	cưỡng
熺	hy
怔	chinh
芝	chi
陭	y,khi
鲱	phi
逋	bô
衟	đạo
劼	cật
穢	uế
报	báo
厨	trù
锅	oa
髴	phất,phí
棅	bính
植	thực,trị,trĩ
朏	phỉ
誌	chí
郯	đàm
唎	lợi
姺	sân,sâm,tiên
謵	tập
簺	tái
閘	sạp,áp
牵	khiên,khản
淬	thối,tụy
诱	dụ
洨	hào
侣	lữ
隧	trụy,toại
轘	hoàn
诇	huýnh,quýnh
寯	tuấn
雨	vụ,vũ,vú
囙	nhân
貶	biếm
橾	táo
綦	kỳ,kì
旦	đán
稞	khoa,khỏa
择	trạch
骓	chuy
鐨	phí
颃	hàng,kháng,cang
銸	triếp,nhiếp
騋	lai
对	đối
瀞	tịnh
鸽	cáp
盐	diêm
蟓	tượng
臠	luyến
丢	đâu
錍	bề,ty,phê
倓	đảm,đàm
雞	kê
陂	pha,bí,bi
剗	sản,sạn
栾	loan
峞	qụy
撿	liệm,kiểm
登	đăng
膕	quắc
僉	thiêm
鯈	du
芧	trữ,tự
紟	cấm,câm
區	khu,âu
閭	lư
鹼	kiềm,giảm,dảm,kiểm,thiêm
挤	tê,tễ
坼	sách
櫪	lịch
锹	thiêu
爛	lạn
邲	tất,bí,bật
蜓	đình
偸	thâu,du
鵌	dư
蜹	nhuế
綖	tuyến,diên
摳	khu
渗	sấm
跱	trĩ
滩	than
浴	dục
质	chí,chất
糐	đoàn
議	nghị
鶴	hạc
鎯	lang
㳠	thát
襁	cưỡng
芻	sô
恧	nục
緺	oa
株	châu,chu
尴	dam,giam
绑	bang,bảng
潤	nhuận
驈	duật
瞈	ổng
專	chuyên
按	án
仞	nhận
爢	mi
釉	dứu
揪	thu,tưu
鄹	trâu,tụ,châu
币	tệ
悧	lợi
痹	tý,tí
樗	sư,xư
捧	phủng,bổng,phụng
瀛	doanh
鯨	kình,canh
癕	ung
羸	nuy,luy
荭	hồng
滨	tân
骁	kiêu
当	đáng,đương,đang
鴟	si
怬	tứ
鏞	dong,dung
贴	thiếp
莊	trang
鳙	dong,dung
硙	cai,ngại
臘	lạp
藑	quỳnh
謥	tổng,tông
獫	hiểm
谫	tiễn
钷	phả
碘	điển
讐	thù
鋈	ốc
獺	thát
汏	đại,thái
舜	thuấn
墨	mặc
镯	trạc
唌	duyên,tiên
弌	nhất
鬒	chẩn
潬	đán
燂	tầm
褐	cát,hạt
蒜	toán
耐	năng,nại
敍	tự
廀	sưu
礝	nhuyễn
诶	hy,ai
跦	trù
僅	cẩn,cận
捃	quấn,quận
渮	ca
馽	trập,chấp
淒	thiến,thê
汹	hung
撼	hám
滎	huỳnh
犍	kiền
偋	bình,bính
麏	quân
年	niên
殗	yểm,yếp,yêm
虹	hồng,hống
醬	tương
豻	ngạn,ngan
馡	phỉ,phi
歙	hấp,thiệp
搪	đường
膍	tỳ,tì,bì
委	uy,ủy
烬	tẫn
郦	lịch,ly,li
缄	giam
潷	tiết
脬	phao
絚	căng
炉	lư,lô
萉	phì,phí,phỉ
菫	cần,cận
喁	ngu,vu,ngung
波	ba
韝	câu
檳	tân
諡	thụy
舫	phang,phảng
鎊	bàng,bảng
捲	quyền,quyển
塋	doanh,oanh
戊	mậu
殹	ê,ế
骛	vụ
饳	đốt
流	lưu
捁	giảo
壻	tế
婑	ỏa,tuy
揖	tập,ấp
腩	nạm
絣	băng,phanh,bình
朌	phần
荟	hội,oái
脅	hiếp
襔	mãn
麁	thô
齮	nghĩ
倷	nại,nãi
蜻	tinh,thanh
痿	nuy
壁	bích
丁	tranh,chênh,trành,đinh
蠖	hoạch,oách
怛	đát
藫	đàm
哨	tiêu,tiếu,sáo
跸	tất
臁	liêm
扚	địch
轱	cô
迴	hồi
詞	từ
璫	đương,đang
鞂	kiết
疗	liệu
甭	bằng
倶	câu
磿	lịch
嫱	tường
瓊	quỳnh
埭	đại
嶱	khát
齯	nghê
巒	loan
健	kiện
孲	nha
鼣	phệ
呵	a,ha
埊	địa
壄	dã
棚	bành,bằng
丌	kỳ,cơ
釬	can,hạn,hãn
厜	tuy
髨	khôn
陊	đọa
待	đãi
瀚	hãn
泧	hoạt
稨	biển
閺	văn
儵	thúc
桑	tang
祇	kỳ,kì,chi,chỉ
宐	nghi
餁	nhẫm
吰	hoành
眴	huyễn,thuấn
僁	tất,tiết
忤	ngỗ
傕	quyết,giác
彧	úc
褔	phúc,phó
黵	đảm
皸	quân
呤	linh
筐	khuông
劔	kiếm
犀	tê
尪	uông
蘊	ôn,uẩn,uấn
绛	giáng
夒	nao
曏	hưởng,hướng
芩	cầm
乡	hưởng,hướng,hương
伐	phạt
芿	nhứng
蜼	lũy,vị,dữu
嘬	toát,soái
朦	mông
鴚	ca
瑨	tấn
殚	đàn,đạn
岳	nhạc
鞌	yên,an
鸝	ly,li
窅	diểu,liểu,yểu
腁	biền
塺	môi
銾	cống,hống
谅	lạng,lượng
颶	cụ
兪	du
賅	cai
氊	chiên
想	tưởng
阊	xương
幌	hoảng
拨	bát
驥	ký,kí
牓	bảng
涚	thuế
凒	ngai
饡	tán
讫	cật,ngật
茼	đồng
铟	nhân
踘	cúc
趍	xúc,tri,xu
押	áp
賬	trướng
稟	bẩm,lẫm
龈	khẩn,ngân
郅	chí,chất
揕	chấm,trấm
妢	phần
紭	hoằng
蜪	đào
嶂	chướng
稆	lữ
嘶	tê,tư
韙	vĩ
齴	nghiễn
阪	phản
姟	cai
滌	địch
滛	dâm
磊	lỗi
僵	cương,thương
尝	thường
們	môn
癱	than
竑	hoành
賫	tê
撬	khiêu
貼	thiếp
鹵	lỗ
嶪	nghiệp
頩	bình,bính
釔	ất
肯	khẳng,khải
鉞	việt,hối
鹠	lưu
铼	lai
蔯	trần
篥	lật
廔	lâu
嘝	hộc
鲖	đồng
瓃	lôi
磡	khám
邇	nhĩ
缔	đế
鮒	phụ
酾	si
幏	giá
劭	thiệu
巜	quái
鵷	uyên
魼	khư
贏	doanh
芔	hủy
騧	quai,qua
诉	tố
抅	câu
扼	ách
隍	hoàng
谋	mưu
烈	liệt
桦	hoa
梫	xâm
軮	ưởng
勅	sắc
绠	cảnh
磵	giản
姤	cấu
側	trắc
晞	hy,hi
椸	di
鸾	loan
栞	san,khan
囦	uyên
龊	xúc
翽	hối
呖	lịch
鲦	điều
函	hàm
灄	nhiếp
歃	sáp
埳	khảm
湑	tư
篦	bề,tỵ,bế
取	tụ,thủ
奘	tráng,trang
亻	nhơn,nhân
飚	biểu
頏	hàng,kháng,cang
饍	thiện
排	bài
禡	mã,mạ
岸	ngạn
匯	hội,hối
璲	toại
势	thế
镛	dong,dung
寨	trại
鼴	yển
網	võng
犷	quánh,quảng
籭	si
俬	tư
閣	các
煮	chử
叩	khấu
疧	kỳ
訌	hồng
黠	hiệt
嫺	nhàn
鬊	thuấn
崘	luân,lôn
贝	bối
画	hoạch,họa
澱	điến
蔨	quyển
女	nữ,nự,nứ,nhữ
嵯	tha
侊	quang
繶	ức
薓	sâm
奐	hoán
屍	thi
畊	canh
呱	oa,cô
铬	các
喹	khuê
剙	sáng,sang
伫	trữ
趡	thủy
妍	nghiên
嫽	liêu
铃	linh
臯	cao
呸	phôi,phi
篴	địch
鐪	lỗ
郙	phu,phủ
慣	quán
缏	biền
獨	độc
瞀	mậu
纕	nhương,tương
碲	đế
况	huống
涏	diên
诧	sá
饃	mô
紱	phất
眣	điệt
烖	tai
锲	khiết
墟	khư,hư
囻	quốc
饣	thực
蓺	nghệ
痁	thiêm
苨	nễ
澔	hạo
妬	đố
扣	khẩu,khấu
丨	cổn
鐖	ky
暵	hán
酴	đồ
鏌	mạc
亿	ức
脩	tu
倬	trác
握	ốc,ác
俆	từ
晄	hoảng
锝	đắc
荫	âm,ấm
凱	khải
竀	sanh
表	biểu
泲	tế,tể
剎	sa,sát
榨	trá
覗	tư
椿	xuân,thung
境	cảnh
觉	giáo,giác
冉	nhiễm
匈	hung
輈	châu,chu
麋	my,mi
带	đái,đới
褱	hoài
趙	triệu
鬎	lạt,thích
顎	ngạc
朓	thiêu,thiểu,thiểm
橃	phạt
竾	trì
砐	ngập
克	khắc
舆	dư
鈌	quyết
噱	cược
呧	để
紇	hột
蚜	nha,gia
谗	sàm
甎	chuyên
老	lão
鸛	quán
餽	qũy
銀	ngân
緐	phiền,phồn
硜	khanh
彷	bàng,phảng
孔	khổng
鹿	lộc
嵺	lũ
觽	huê
抍	chửng
腴	du
噲	khoái,hồi
允	duẫn,doãn
妆	trang
繿	lãm
晖	huy
旭	húc
苋	hiện
鍿	truy
鷴	nhàn
蛀	chú
悯	mẫn
霫	tập
瓟	bạc
蔩	dần
碶	khế
叁	tam
礥	hiền
蜦	luân
融	dong,dung
爽	sảng
諮	ty,tư,ti
箟	côn,khuân
甹	phinh
袀	quân
艅	dư
瑠	lưu
碚	bội
哓	hiêu
鏭	tất
窨	huân,ấm
饜	yếm
収	thâu
燋	tiêu,tiều
牛	ngưu
悶	muộn,môn
諗	thẩm
缪	mâu,cù,mục,mậu
餻	cao
襝	liêm,liễm
盬	cổ
坰	quynh
擎	kình
茇	bạt,bát,bái
睺	hầu
攟	quấn
苯	bổn,bản
镋	đảng
唡	lượng
惀	luân
蛜	y
鬓	mấn,tấn
挈	khiết,khế,kiết
叒	nhược
蟋	tất
诵	tụng
罷	bãi,bì
餐	xan
埶	nghệ,thế
某	mỗ
綼	bích
贍	thiệm
羑	dữu,dũ
枰	bình,bính
揫	thu,tưu
魍	võng
斈	học
鶺	tích
砑	nhạ,nha
虦	sàn
潒	tượng
攗	quấn
钐	sam,sán
厫	ngao
毦	nhị
怐	khấu,cú
谵	thiềm,chiêm,thiêm
蕞	tối,tụi
玛	mã
擪	áp
隝	đảo
譴	khiển
靁	lôi
擘	phách,bịch,bài
焸	cảnh
溶	dong,dung
葙	tương
莯	mộc
兦	vong
飠	thực
籸	sân
骊	ly,li
搃	tổng
厙	xá
灭	diệt
桺	liễu
囅	sản,xiên,xiển
譙	tiều,tiếu
眊	mạo
溫	ôn,uẩn
締	đề,đế
撐	sanh,xanh
贩	phiến,phán
胭	yên
麯	khúc
馓	tản
锇	nga
纘	toản
骘	chất
箐	tinh,thiến
鷟	thốc,trạc
袍	bào
覽	lãm
諳	am
静	tịnh,tĩnh
侉	khoa
涳	không
设	thiết
摼	khinh,khiên,khanh
勒	lặc
岐	kỳ,kì
戼	mão
璜	hoàng
椳	ôi
铘	da
魴	phường
賵	phúng
複	phức
焕	hoán
缯	tăng
淪	luân
蒵	hệ
柊	chung
柲	biết
蒀	uân
鶒	xích
筝	tranh
鰓	tai
礔	tích
襙	thao
祕	bí
苒	nhiễm
澫	vạn
帉	phân
邁	mại
鵪	am
輚	trản
偝	bội
良	lương
饐	ý
倲	đông
站	trạm
呑	thôn
岝	trách
歷	lịch
頑	ngoan
歡	hoan
喉	hầu
辣	lạt
劣	liệt
衃	phôi
宧	di
喫	khiết
氄	nhũng
俔	hiện,khiếm
踋	cước
嚪	đạm
摣	tra
宭	quần
肰	nhiên
喳	tra
嚄	hoát,hoạch
結	kế,kết
饽	bột
餌	nhĩ,nhị
项	hạng
愆	khiên
菭	đài
鶵	sồ
痍	di
徴	trừng,trưng,chủy
鴦	ương
疱	pháo,bào
阉	yêm
趱	toản
垞	xá
菲	phỉ,phi
尘	trần
冊	sách
綻	trán
织	chí,xí,chức
骒	khỏa
咄	đoát,đốt
憼	kỉnh
釺	thiên
憏	sế
殰	độc
瞼	kiểm
偃	yển
优	ưu
棟	đống
鎬	hạo,cảo
锐	duệ,nhuệ
紜	vân
荪	tôn
榎	giả
抇	hột
雧	tập
禠	ty,tư,ti
锆	cáo
帷	duy
馣	am
軡	linh
嘹	liệu
揿	khấm
便	tiện
凜	lẫm
鐺	sanh,đương,thang,đang
纤	khiên,tiêm
汉	hán
鄸	mộng
閍	banh
矼	khang,cang,xoang
鍆	môn
昫	hú,hu
昆	côn
冓	cấu
蝼	lâu
劂	quyết
锞	qủa
唘	khởi,khải
鹋	miêu
落	lạc
鎷	mã
陉	hình,kính
厔	chất
廾	nhập,củng,trấp
苏	tô
膗	sùy
镓	gia
鏐	liêu,lưu
毊	hiêu
锿	ai
翠	thúy
刵	nhĩ,nhị
絸	kiển
馊	sưu
氳	uân
饭	phạn,phãn
偹	bị
迈	mại
后	hậu,hấu
罳	ty,ti
梆	bang
朐	cù
粧	trang
劝	khuyến
牼	khanh
貀	nột
狒	phí
熟	thục
齝	si
臅	xúc
别	biệt
叄	tam,tham
韐	cáp
谁	thùy
肘	trửu,chửu
喞	tức
捎	sao,tiêu,siếu
蔂	luy
檎	cầm
憓	huệ
穉	trĩ
筌	thuyên
跑	bào
帐	trướng
辘	lộc
駭	hãi
咖	già,ca,gia
荄	cai
镤	bộc
赑	bí
僎	soạn,tuân,chuyến
稃	phu,phù
唣	tạo
玕	can
阰	tì,tỳ
韮	cửu,phỉ
躗	vệ
寞	mịch
廵	tuần
蕩	đãng,đảng
舠	đao
巷	hạng
摘	trích
猧	oa
糝	tảm
囉	la
噰	ủng,ung
犦	báo
鈿	điến,điền
黳	ê
鷹	ưng
务	vụ,vũ
筩	đồng
幵	kiên
脀	chức
憎	tăng
鄘	dong,dung
紺	cám
穊	ký
蠚	nhược
剅	lâu
痾	kha,a
殓	liệm,liễm
慢	mạn
捣	đảo
凾	hàm
焱	diễm
噇	sàng,tràng
貭	chất
帍	hộ
园	viên,ngoan
骤	sậu
瞥	miết
皯	cán
潟	tích
纋	ưu
攍	doanh
詰	cật
嗨	hải
跢	đa,trì,đá
酂	tán,toản
翆	thúy
羦	hoàn
榉	cử
匙	thi
惥	dũng
惫	bại,bị
潆	oanh,uynh
勠	lục
喍	sài
駥	nhung
颁	phân,ban
捾	oát
珈	già,gia
濠	hào
捬	phủ,phụ
霱	duật
萑	hoàn,chuy
譈	đỗi
锣	la
塑	tố
繜	tôn
傩	na
购	cấu
疙	ngật
夗	uyển
皼	cổ
庾	dữu
垺	phu,phù,bôi
傝	tháp
纒	triền
襤	lam
妃	phối,phi
睮	du
哹	phù
鳢	lễ
荧	huỳnh
崭	tiệm
櫍	chất
燐	lân
误	ngộ
訒	nhẫn
驍	kiêu
寘	trí
榣	dao
却	tức,khước,ngang
褘	y,huy
媱	dao
胲	cai,hợi,cải
肄	tứ,dị
鴨	áp
闯	sấm
氾	phiếm
訖	cật,ngật
専	chuyên
鑵	quán
拭	thức
煢	quỳnh
胍	cô
踧	túc,địch
镪	cưỡng,cường
娙	nghinh
陁	trĩ,di
铨	thuyên
遉	trinh
毽	kiến,kiện
孵	phu,phụ
唪	phủng
浟	du
遢	tháp
照	chiếu
兴	hưng,hứng
唉	ai
錮	cố
蟬	thiền,thuyền
锥	chùy,trùy
儆	cảnh
鏃	thốc
敓	thoát
錒	a
眛	muội
羥	khan
鲵	nghê
情	tình
蓟	kế
𨐅	thù
曭	đảng
餘	dư
整	chỉnh
注	chú
床	sàng
躱	đóa
鄏	nhục
燦	xán
恾	mang
燼	tẫn,tấn
壔	đảo
瓘	quán
禮	lễ
咢	ngạc
剉	tỏa
澾	thát
猂	hãn
叵	phả
搚	hiếp,lạp
僤	đàn,đạn,đản
誠	thành
拒	cự,củ
嗟	ta
蜢	mãnh
澨	phệ,thệ
爪	trảo
茈	sài
創	sáng,sang
岨	thư
澦	dự
怃	hủ,vũ
餪	noãn
走	tẩu
綳	băng,banh
缟	cảo
盖	cái
鳷	chi
襘	quái
圤	phác
超	siêu
冏	quýnh
祼	lõa,quán
魇	yểm
峆	hàm
餢	bẫu
衆	chúng
捉	tróc
牎	song
悚	tủng
鱮	tự
蓆	tịch
惆	trù
謦	khánh
鹌	am
筇	cung
盉	hòa
脣	thần
咦	di
艢	tường
聵	hội
熄	tức
鐄	hoành
嵋	my,mi
媛	viên,viện
疒	nạch
割	cát
觏	cấu
娅	á
齧	niết,khiết
辽	liêu
輨	quản
㯲	cấm
丩	cưu
瀩	đội
肜	can,dung
顮	tân
閛	phanh
嚀	ninh
觸	xúc
牷	toàn
擒	cầm
螅	tức
憝	đỗi,đội
曖	ái
倢	tiệp
堮	ngạc
瑋	vĩ
枼	diệp
胫	hĩnh
溙	thái
錨	miêu
毼	hạt
篓	lũ,lâu
溢	dật
缀	chuế,chuyết,xuyết
恍	hoảng
篺	bài
綝	lâm,sâm
斟	châm
湩	chúng,đống
伽	già,cà,gia
嘫	nhiên
帽	mạo
犠	hy
鑢	lự
憞	đội
啓	khởi,khải
彞	di
另	lánh
歌	ca
窥	khuy
魎	lưỡng,lượng
昼	trú
蒓	thuần
俵	biểu
㧟	khối
糒	bí,bị
竭	kiệt
斎	trai
糨	cưỡng
浏	lựu,lưu
怜	lân,liên,linh
蝰	khuê
藂	tùng
縡	tể
晳	tích,triết,chế
奩	liêm
聍	ninh
怩	ni
艮	cấn
笏	hốt
刼	kiếp
沲	đà
螾	dẫn
槩	khái
裋	thụ
髹	hưu
銠	lão
绡	tiêu
聼	thính
唵	ảm,án,úm
柝	thác
天	thiên
聫	liên
幘	trách
瘾	ẩn
鷐	thần
裳	thường
旵	sảm
治	trị,trì
督	đốc
鲈	lư,lô
眽	mạch
蝣	du
讯	tấn
曀	ê,ý,ế
突	đột,gia
嬺	nật
锶	tư
睟	túy
享	hưởng
耾	hoành
呎	xích
蟌	thông
誽	nghệ
敷	phu
砍	khảm
置	trí
恔	hiệu
闹	náo,nháo
賉	tuất
嚛	hộ
穪	xưng
攢	toàn,toản
距	cự
褻	điệp,tiết
撃	kích
昝	tảm
螖	hoạt
騴	yến
旴	húc,hu
彗	tuệ
灪	uất
蛚	liệt
砦	trại
笻	cung
曝	bộc
萹	phiên,biển
槈	nậu
嵗	tuế
程	trình
廛	triền
圆	viên
嘙	bà
洚	giáng,hồng
嵬	ngôi,nguy
惔	đạm,đàm
夬	quyết,quái
隸	lệ
曇	đàm
鹅	nga
歈	du
惃	côn
卤	lỗ
諐	khiên
怏	ưởng
柷	chúc
磬	khánh
蛬	cung
燭	chúc
佥	thiêm
駺	lang
穆	mặc,mục
鵂	hưu
騃	ngai,ngốc,ngãi,sĩ
攏	long,lung,lũng
奡	ngạo
牟	mâu,mưu
濾	lự
棱	lăng
逯	đãi,lục,đệ,lộc
蔱	sát
鄛	sào
螀	tương
鬍	hồ
誕	đản
勪	kiểu
搣	diệt
賷	tê
籖	thiêm
漣	liên
縜	vận
滘	khiếu
滸	hử
趟	thảng,tranh
榷	các,giác
韵	vận
酅	hy,huê
罵	mạ
烱	huỳnh,quýnh
撈	liệu,lao
玔	xuyến
饤	đính
缅	miến,diến,miễn
犐	khoa
贊	tán
庮	dậu
嗶	tất
翅	sí
惾	tông
跴	tẩy,thải
殂	tồ
欘	chúc
竻	lặc,cân
蠩	chư
鮍	bì
譌	ngoa
擽	lịch
揢	khách
搗	đảo
澂	trừng
虼	khất
紽	đà
哽	ngạnh
婢	tì,tỳ
册	sách
勗	úc,húc
猢	hồ
统	thống
褳	liên
溘	khạp
买	mãi
竢	sĩ
觧	giải
揔	tổng
囈	nghệ
鄵	tháo
諏	tưu
嚻	hiêu
迵	đồng
翎	linh
𫐇	nạp
稊	đề
櫳	long,lung
勺	chước,thược
惸	quỳnh
唏	hy,hi,hý
蛃	bính
婗	nghê
迎	nghinh,nghịnh,nghênh
窘	quẫn
儮	lịch
閩	mân
磋	tha
锢	cố
蠹	đố
倾	khuynh
罐	quán
凥	cư
碃	thanh
枫	phong
繸	toại
脲	niệu
蚹	phụ
卞	biện
垾	hạn
蛮	man
懬	khoáng
畀	tý,tí
剷	sản
愒	khái,khế
巃	lung
髯	nhiêm
鍇	khải,hài
宅	trạch
轰	hoanh,oanh
秊	niên
𤅷	linh
迒	hàng
箨	thác
虎	hổ
塊	khối
桧	cối
桐	thông,đồng
疽	thư
崒	tụy,tột,tốt
餟	chuyết
販	phiến,phán
幚	bang
欂	bách,bạc
舭	tỳ
幺	yêu
隺	hộc,hạc
煻	đường
婧	tinh
襇	giản,cán
夀	thọ
輿	dư
聂	niếp,nhiếp
媓	hoàng
炆	văn
锁	tỏa
鴉	nha
鉸	giảo
硉	luật,lột
翱	cao,ngao
皠	thối
獾	hoan
邈	mạc
礹	nham
餿	sưu
瑰	côi,khôi
缬	hiệt
堣	ngung
滅	diệt
徬	bàng,bạng
苷	đại
桡	kiêu,nạo,nhiêu
崺	dĩ
芴	hốt,vật
毂	cốc
嫗	ủ,ẩu
瓽	đáng
晫	trác
蟈	quắc
盭	lệ
垔	yên,nhân
燀	sán,xiển
顺	thuận
诋	để
澆	kiêu,nghiêu
闉	nhân
谑	hước
腼	điến,điển,diến
寬	khoan
峛	lị,lệ
笄	kê
蒶	phần
鉭	đán
剧	kịch
骕	túc
策	sách
吆	yêu
楫	tiếp
癑	nung,nùng,nồng
愜	khiếp,thiếp
傧	tấn,tân
猓	qủa
磁	từ
拱	củng
溜	lựu,lưu
砠	thư
巩	củng
瘺	lũ
痶	điển
砷	thân
螜	hộc
枩	tùng
閤	cáp,hợp,hạp
躍	dược,thích
摷	tiễu,sào
拆	sách,xích
葡	bồ
彃	tất
嫜	chương
盥	quán
鏂	âu
骹	khao
嬪	tần
譆	hy,hi
給	cấp
艟	đồng
牙	nha
摚	đường
糦	xí
狪	thông
疷	chi
浙	chiết,triết
鷃	yến
鏦	thung
阀	phiệt
祎	y
舩	thuyền
鯇	cán
闟	hấp,tháp
伉	kháng
絼	trẩn
揸	tra
鲥	thì
笺	tiên
閨	khuê
簡	giản
绲	cổn
楰	du
稛	khổn
褑	viễn
砆	phu
奁	liêm
敿	kiểu,kiều
姙	nhâm
敫	kiểu
挵	lộng
备	bị
裝	trang
讧	hồng
唱	xướng
鞓	thinh
攦	lệ
鋀	du,đậu
楳	kì,mai
炬	cự
倽	xá
挣	tranh,tránh
矽	tịch
谍	điệp
兊	đoài,đoái
憴	thằng
绅	thân
秝	lịch
沙	sá,sa
旅	lữ
俇	cuống
氙	tiên
嗧	gia luân
襐	tượng
郕	thành
麦	mạch
閎	hoằng,hoành
瞵	lân
閽	hôn
秸	kiết
鬠	quái
钍	thổ
搰	cô,cốt,hột
尰	thũng
诼	trác
傅	phu,phó,phụ
夕	tịch
廱	ung
眞	chân
漦	ly
儩	tứ
矻	ngột,khốt
埰	thái,thải
醖	uấn
詔	chiếu
蚃	hưởng
恋	luyến
皽	cha,triển
菹	trư,thư
鱼	ngư
赯	đường
睦	mục
捨	xả
纱	sa
偵	trinh
瑉	mân
砸	tạp
酿	nhưỡng
慶	khánh,khương,khanh
絅	quynh,quýnh
殑	căng
巨	cự,há
恣	thư,tứ
噸	đốn
颞	nhiếp
桰	quát
屁	thí
絙	căng
麻	ma
粘	niêm
彯	phiêu
樔	tiễu,sào
鈀	bả,ba
郝	hác
磏	liêm
劇	kịch
朾	tranh
譱	thiện
雔	thù
俧	chi
宋	tống
蘓	tô
晓	hiểu
俐	lị,lợi
汸	bàng
哱	phá,bột
艪	lỗ
锠	xương
簒	thoán,soán
瘨	điên
媮	thâu,du
溝	câu
謰	liên
疈	phúc
騄	lục
遏	át
婶	thẩm
鎇	my
詆	để
全	toàn
絫	lũy
芏	đỗ
漫	mạn,man
赈	chẩn
蟠	bàn,phiền
斧	phủ
嘎	dát,ca,kiết
缭	liễu
韽	am
愉	thâu,du
邡	phương,phóng
躨	qùy
谚	ngạn
疛	chửu
浒	hử
悂	bì
弯	loan
業	nghiệp
嘕	hiên
攂	lôi,lụy
嚕	lỗ,rô
鬧	náo,nháo
楀	vũ
堺	giới
匊	cúc
炙	chá,chích
曜	diệu
壅	úng,ủng,ung
蔇	ký
論	luân,luận
擠	tê,tễ
冷	lãnh
閆	diêm
誐	nga
棨	khể,khải
輒	triếp
鹍	côn
鐲	trạc
铒	nhĩ
覓	mịch
蓬	bồng
睋	nga
篱	ly,li
叹	thán
澘	san
醅	phôi
砥	để,chỉ
袒	đản
撤	triệt
堩	căng
葱	thông,song
胦	ương
绉	trứu
暾	đôn,thôn
蚡	phân,phẫn,phần
痣	chí
男	nam
练	luyện
勛	huân
悉	tất
掃	táo,tảo
痃	hiền,huyền
懷	hoài
硷	dảm,kiềm,thiêm
窳	dũ
擭	hoạch,hộ,oách
鰎	kiển
獃	ngai,ngốc
詡	hủ,hu
兲	thiên
森	sâm
邨	thôn
璙	liêu,liệu
帮	bang
勱	mại
蔉	cổn
鷫	túc
沼	chiểu
撖	hạm,hàn
魕	kỳ,kì
亼	tập
錹	khẳng
際	tế
抆	vẫn,vấn
員	viên,vân
狢	hạc
昢	phốt
唶	giới,tá,trách,tắc
圳	quyến
赪	trinh,xanh
鸯	ương
倪	nghê
僾	ái
鬪	đấu
犯	phạm
瀾	lan
犧	hy,hi
擯	bấn,thấn,tấn
辳	nông
愷	khải
葖	đột
焫	nhiệt
蚉	văn
緹	đề
禎	trinh
礒	nghị
艨	mông
陵	lăng
蒠	tức
覼	kiến,la
墼	kích
琲	bội
髪	phát
壝	duy
繞	nhiễu
楬	kiệt,kệ
絰	điệt
幩	phần
鄚	mạc,mạo
碻	nghiêu,xác
坛	đàn,đàm
簉	sứu,sửu
窠	khoa,khỏa,khòa
筞	sách
衕	đồng
迸	bình,bính
駝	đà,trì
滶	ngao
箴	châm
侖	luân,lôn
让	nhượng
絶	tuyệt
梩	tỷ
肃	túc
敽	kiểu
誻	đạp
雄	hùng
蹜	súc,xúc
闌	lan
苜	mục
塥	cách
屼	ngột
𥞵	giáp
饋	qũy
墠	thiện
诞	đản
凿	tạc
灿	xán
珥	nhĩ,nhị
卌	tấp
鵲	thước
燧	toại
態	thái
羗	khương
彣	văn
戬	tiển
狱	ngục
濰	duy
歛	liễm
輔	phụ
藭	cùng
颳	quát
骱	giới
譫	thiềm,chiêm,thiêm
楼	lâu
僒	quẫn
婸	sướng
螪	thương
鼫	thạch
黑	hắc
寄	ký,kí
浮	phù
縢	đằng
氉	táo
到	đáo
骙	qùy
癘	lệ
睠	quyến
迓	nhạ
塕	ổng
賟	thưởng
厯	lịch
痊	thuyên
啶	đính
賾	trách
鬱	úc,uất
絲	ty,ti
剂	tề,tễ,tệ
銣	như
蝨	sắt
靉	ái
桥	khiêu,cao,kiều
粗	thố,thô
茺	sung
捷	thiệp,tiệp
鵓	bột
僈	mạn
坠	trụy
淖	náo,xước
渙	hoán
惏	lâm,lam,lẫm
竝	tịnh
蟡	qụy
瘡	sang
帟	diệc,dịch
呉	ngô
俚	lí,lý
戗	sang,thương
銲	hạn,hãn
嬍	mĩ,mỹ
皴	thuân
痂	già,gia
幫	bang
戔	tàn,tiên
荘	trang
驂	tham
絭	quyến
殢	đế,thế
踢	thích
急	cấp
衡	hành,hoành
师	sư
颸	ty,ti
萦	oanh
顝	cốt
鉦	chinh
玅	diệu
瑗	viện
琤	tranh
驘	loa,la
瀑	bạo,bộc
衭	phu
靰	ngột
衫	sam
班	ban
佺	toàn,thuyên
亝	tề
肊	ức
鹊	thước
燿	sảo,diệu
毲	đát
礎	sở
逹	đạt
裹	khỏa,khõa,lõa
抡	luân
课	khóa
鐍	quyết
浐	ngạn
務	vụ,vũ
銘	minh
凡	hoàn,phàm
妔	hàng,khanh
汞	cống,hống
歭	trĩ
执	chấp
萨	tát
穭	lữ
篤	đốc
璎	anh
斉	tề
酱	tương
泔	hạm,cam
軷	bạt
覧	lãm
蕨	quyết
韅	hiển
渀	biện
儻	thảng
辙	triệt
雁	nhạn
躈	khiếu
麒	kỳ,kì
蓘	cổn
葳	uy
哷	liệt
醧	âu
琦	kỳ,kì
楣	my,mi
繪	hội
右	hữu
仵	ngỗ
齙	bao
壩	bá
阛	hoàn
籗	trạc
駟	tứ
妣	tỷ,tỉ
奎	khuê
啊	á,a
鰱	liên
像	tượng,tương
葥	tiền
陾	nhưng
劌	quế
蔎	thiết
裏	lí,lý
婁	lũ,lâu,lu
馑	cận
连	liên
抽	trừu
驄	thông
橘	quất
媍	phụ
鳔	phiêu
烹	phanh
倹	kiệm
髢	thế
瑕	hà
衇	mạch
蚊	văn
糤	tản
嶌	đảo
财	tài
俳	bồi,bài
箒	trửu,chửu
问	vấn
暦	lịch
讶	nhạ
敲	xao
竄	thoán,soán
岈	ha
玮	vĩ
閏	nhuận
覇	phách,bá
蔼	ái
糅	nhữu
嵊	thặng
殣	cận
沃	ốc
隯	đào
敤	khỏa
碓	đối
裷	cổn
衹	kỳ,chỉ
幬	đào,trù
埔	phố,bộ
蔀	bộ
甓	bích
擅	thiện
轑	liêu,liệu,lao
愯	tủng,song
靭	nhận
犿	phiên
徠	lại,lai
骷	khô
辞	từ
嗢	ốt,miệt
鄍	minh
珰	đương,đang
扻	tiết
谢	tạ
笳	già,gia
渫	điệp,tiết
镇	trấn
筓	kê
义	nghĩa
准	chuyết,chuẩn
傓	phiến
騪	sưu
袾	chu
傣	thái
婇	thể
瑚	hô,hồ
蠯	bảnh
匶	cựu,cữu
瘋	phong
靛	điện
丂	khảo
钫	phương
綕	chức
潐	tiêu
輁	củng
蝴	hồ
萘	nại
眹	trẫm
畽	thoản,thỗn
籄	qũy
孋	ly
崥	tỷ
描	miêu
噀	tuyển,tổn,tốn
纈	hiệt
黒	hắc
拷	khảo
蜉	phù
渡	độ
鐎	tiêu
迹	tích
豚	độn,đồn
淌	thảng,xướng
溱	trân,trăn
熸	tiêm
鹖	hạt
抱	bão,bào
蛒	cách
蝸	oa,qua
嫛	ê
悸	qúy
嚎	hào
秠	phi
楚	sở
式	thức
菴	ám,am
颍	dĩnh,toánh
判	phán
寉	hạc
瀫	hộc
悮	ngộ
倘	thảng
熤	tập
鑲	nhương,tương
猃	hiểm
惓	quyền,quyển
踌	trù
殁	một
灛	xiển
佧	kha
胶	giao
黁	nuyên
毱	cúc
莗	xa
銛	thiểm,quát,tiêm
繽	tân
亾	vong
赓	canh
鮫	giao
戌	tuất
汶	mân,môn,vấn
懪	bạc
烨	diệp
槢	tập
淥	lục
噆	thản
濔	nhĩ
賛	tán
苓	linh
字	tự
翘	kiều
輙	triếp
龑	yểm
倧	tông
騯	bàng
槌	chùy,trùy,đôi
诃	ha
毤	thóa
嚞	triết
抾	kiếp,khư
櫢	tẩu
駂	bảo
従	tòng
肸	hất,hật,bị
蜿	uyển
顛	điên
懔	lẫm
双	song
西	tê,tây
巖	nham
廸	địch
湢	bức
黰	chẩn
灃	phong
魏	nguy,ngụy
蜆	hiện
谠	đảng
鬿	kỳ
写	tả
刦	kiếp
亳	bạc
浜	binh,banh
峊	phụ
鏇	toàn,tuyền
騽	tập
簶	lộc
稜	lắng,lăng
匳	liêm
恚	huệ,khuể
蛐	khúc
瑶	dao
篷	bồng
嚃	tháp
憁	tổng
剖	phẫu
龢	hòa
瑭	đường
罇	tôn
睥	bễ
砰	phanh
靷	dẫn
嘞	lặc
胴	đỗng
塟	tang,táng
謔	hước
铢	thù
顶	đính,đỉnh
粻	trương
谇	tối
藹	ái
騌	tung,tông
伦	luân
薋	tư
篮	lam
駬	nhĩ
鲪	quân
侀	hinh
拇	mẫu
仆	phó,bộc
赩	hách
殄	điễn,điển
馉	cốt
窀	truân
蔕	đế
怼	đỗi
熬	ngao
齓	sấn
霆	đình
醫	y,ỷ
賮	tẫn
孰	thục
飏	dương
蓓	bội
砚	nghiễn
駰	nhân
靠	kháo,khốc
胁	hiếp
魙	tiệm
蓉	dong,dung
滾	cổn
柎	phu,phủ,phụ
遛	lựu,lưu
鍳	giám
巾	cân
嘾	đảm
妤	dư
螼	cẩn
嚦	lịch
荚	giáp
悼	điệu,nạo
嘷	hào
熰	âu
歯	xỉ
菿	đáo
惚	dịch,hốt
戢	tập
拪	thiên
戸	hộ
底	để
榴	lựu,lưu
鵰	điêu
髼	bồng
帘	liêm
祖	tổ
喿	táo
猷	du
籞	ngữ
齷	ác
枑	hộ
斬	trảm
牴	để
摢	sư,xư,hồ,hộ
帳	trướng
糕	cao
鑮	bạc
宍	nhục
鳦	ất
腭	ngạc
熊	hùng
錠	đĩnh
圀	quốc
扫	táo,tảo
痯	quản
漈	tế
衁	hoang
譹	hạo,hiệu
慼	thích
颅	lô
篆	triện
铇	bào
觵	quang,quăng
徽	huy
禰	nễ,nỉ
奋	phấn
亠	đầu
剟	xuyết
嘟	đô
熒	huỳnh
泚	thử
驆	tất
驶	sử
恑	qủy
衞	vệ
畐	phúc
鋯	cáo
钏	xuyến
裤	khố
朢	vọng
簁	si
坨	đà
炜	vĩ
迩	nhĩ
潔	khiết
桨	tưởng,tương
董	đổng
狺	ngân
湆	khấp
𢒎	phi
聯	liên,liễn
沣	phong
骸	hài
佞	nịnh
驎	lân
馀	dư
褙	bối
袸	tiến
鴷	liệt
訓	huấn
筣	lê
轿	kiệu
鄐	súc
艱	gian
罄	khánh
偕	giai
遫	tốc
谒	yết
谩	mạn,man
媔	miên
馻	duyện
丣	dậu
芨	cập
觩	cầu
諫	gián
甌	ẩu,âu
踽	chủ,củ
玤	bổng
轍	triệt
讹	ngoa
興	hưng,hứng
渟	đình
堅	kiên
蹪	đồi
欋	cù
栴	chiên
涟	liên
胯	khóa,khố
螗	đường
棡	cương
僃	bị
滂	bàng
傈	lật
希	hy,hi
𤏡	bặc
辊	cổn
嗹	liên
墑	thương
庽	ngụ
麎	thần
挱	ta,sa
挦	triêm,tầm
疼	đông
俺	yêm
峄	dịch
釆	biện
蚖	nguyên,ngoan
閫	khổn
髤	hưu
糙	tháo
菽	thục,thúc
矇	mông
瞖	ế
耩	giảng
珅	thân
痱	phỉ,phi
蔔	bặc,bốc
樴	chức
菓	qủa
羌	khương
纸	chỉ
麈	chủ
薽	chân
袪	khư
侍	thị
癃	long,lung
蚳	trì,chỉ
觓	cầu
楨	trinh
燅	tầm
驑	lưu
惶	hoàng
俻	bị
战	chiến
瞚	thuấn
婊	biểu
吮	duyện
發	phát,bát
攅	toàn
暐	vĩ
韡	vĩ,ngoa
鉅	cự
语	ngữ,ngứ
柃	linh
嫠	ly,li
缿	hạng
骧	tương
煌	hoàng
讋	triệp
闰	nhuận
黶	yểm
揀	giản,luyến
貎	nghê
赆	tẫn
薱	đối
艐	tông
薏	ý
竽	vu
寇	khấu
藐	mạc,miễu,miểu
珪	khuê
邢	hình
蘤	hoa,vị
恽	uẩn
赊	xa
东	đông
鈴	linh
钱	tiền,tiễn
荣	vinh
襂	sam,sâm
惐	vực
哟	yêu
矴	đĩnh,đính
嶼	dữ,tự,dư
蒌	lâu,liễu
捶	trùy,chủy,chúy
絷	trập
恱	duyệt
砭	biêm
肪	phương
髳	mâu
岬	giáp
訶	ha
柣	trật
腝	nạo,nê
槉	tật
嵆	kê
汓	tù
蕓	vân
嗌	ích,ác,ách,ái,ải
礅	đôn
煃	khuể
庞	bàng
刌	thiển
锋	phong
唷	dục
调	điệu,điều
鑔	sát
脐	tề
舷	huyền
脔	luyến
裙	quần
註	chú
愅	cách
狻	toan
栓	xuyên,thuyên
華	hóa,hoa
鵴	cúc
唓	xa
铍	phi
玎	đinh
耎	nhuyễn
耴	ngất,nhiếp
伾	phi
黕	đảm
婩	nghiễn
将	tướng,thương,tương
产	sản
缤	tân
饗	hưởng
麧	hột
除	trừ
敳	ngai
廇	lựu
觫	tốc
鐏	tôn,tỗn
菋	vị
硊	ngụy
璞	phác
槾	man
忖	thổn,thốn
蝠	bức
觐	cẩn,cận
縋	trúy,trùy
唒	dẫu
馯	khan,han
秪	chi
覡	hích
敺	ẩu,khu
闃	khuých
绽	trán
趑	tư
郏	giáp
頞	át
濿	lệ
坟	bổn,phẫn,phần
慟	đỗng,động
誼	nghị
騾	loa,la
蘩	phiền
虱	sắt
鐿	ý
縧	thao
褽	úy
謏	tiểu,tẩu
轒	phần
诙	khôi
列	liệt
紃	tuần,xuyên
堁	khỏa
殲	tiêm
碼	mã
锟	côn
娛	ngu
润	nhuận
豂	liêu
萭	câu,vũ
酋	tù
洋	dương
幙	mạc
嫩	nộn
塵	trần
靪	đinh
秺	trà
枿	nghiệt
籜	thác
腎	thận
鼍	đà
蠲	quyên
蒒	sư
妖	yêu
鎋	hạt
蔗	giá
駢	biền
鏰	băng
涌	dũng
繛	xước
焞	đôn
纥	hột
酣	hàm
濄	qua
挲	ta,sa
鼨	chung
罗	la
啣	hàm
锴	khải,hài
览	lãm
囬	hồi
歧	kỳ,kì
惉	siêm
羞	tu
褂	quái
皺	trứu
呪	chú
牏	du
敜	niếp
氕	phân
貅	hưu
虤	ngan
茂	mậu
踬	chí,trí
昴	mão
炁	khí
帑	thảng,nô
帝	đế
歉	khiểm
潺	sàn
繲	giải
镮	hoàn
緲	diểu,miểu
利	lợi
搹	ách
螈	nguyên
褭	niểu
嫔	tần
谪	trích
膏	cao,cáo
衚	hồ
穾	yểu
鷇	cấu
地	địa
坿	phụ
衎	khán,khản
蜑	đản
綣	quyển
搵	vấn,uấn
觌	địch
穐	thu
貐	dũ
組	tổ
辬	ban
雥	tập
揌	tai
騏	kỳ,kì
柫	phất
穋	lục
鮓	trá,trả
壇	đàn
鄰	lân
甬	dõng,dũng
滗	tiết
鳄	ngạc
挳	khinh
尅	khắc
缜	chẩn
穠	nùng
巔	điên
鮣	ấn
豟	ách
漬	tý,tí
齺	trâu
懃	cần
猜	thai,sai
襞	bích
纣	trụ
摙	liễn
住	trụ,trú
蝓	du
珞	lạc
燥	táo
薗	viên
剏	sáng,sang
戆	tráng
冡	mông
淆	hào
辖	hạt
騇	xá
慊	hiềm,khiếp,khiết,khiểm
撜	chửng,trành
讕	lan
旧	cựu
頺	đồi
漙	đoàn
蛤	cáp
联	liên
鯽	tức
涉	thiệp
膧	đồng
睤	bễ
痪	hoán
薅	hao
羼	sạn
屭	hí,hý
泵	bơm
映	ánh
坱	dưỡng,ương
涒	thôn,uân
瘐	dũ
檣	tường
崇	sùng
覶	loa,la
馌	diệp,ấp
席	tịch
礉	khiếu
艏	thủ
糱	nghiệt
崋	hoa
粟	túc
孴	nghĩ
堰	yển
鞍	yên,an
緆	tích
螟	minh
綀	sư,sơ
桫	sa
抝	ảo
驨	huê
禛	chân
灉	ưng,ung
鹢	nghịch
桋	đề,di
鹞	diêu
囚	tù
阝	phụ
𦕒	điêm
寸	thốn
瓛	hoàn
续	tục
旯	lạp
蔟	thốc,thấu
铑	lão
捊	phu,bào
渿	nại
頴	dĩnh
猖	xương
鍚	dương
肿	trũng,thũng
谺	ha
鰭	kỳ,kì
澈	triệt
酬	thù
術	toại,thuật
漢	hán
淩	lăng
韠	tất
薪	tân
誫	chấn
媽	mụ,ma
乴	tích
籙	lục
丄	thượng
欬	ái,khái
裁	tài
綠	lục
俊	tuấn
搨	tháp
羀	duy,lữu
鑨	lung
鉥	thuật
搳	hoa,hạt
蜣	khương
鏵	hoa
窛	khấu
蒢	trừ
澩	hạc
蜗	oa
銫	sắc
峦	loan
鐘	chung
缇	đề
斮	trước,trác
鳕	tuyết
鞝	chưởng,thượng
襹	si
敉	mị
罰	phạt
鍘	trát
誚	tiếu
肋	lặc
跶	thát,đáp
鷕	diểu
掬	cúc
鳃	tai
仰	nhạng,ngang,ngưỡng
姹	xá,sá
亰	kinh
杏	hạnh
噠	đát
昭	chiêu,thiều
協	hiệp
挚	chí
鐐	liêu
内	nạp,nội
钥	thược
茧	kiển
碡	độc
疢	sấn
寰	hoàn
舸	khả
眑	yểu
紧	khẩn
踤	tụy,tột
瓔	anh
晒	sái
楯	thuẫn
輷	oanh
猍	lai
觯	chí
黟	y
彿	phất
邴	bỉnh,bính
蕭	tiêu
嗆	sang,thương
逃	đào
葶	đình
猩	tinh
睗	thích
令	lịnh,linh,lệnh
猈	bãi
懇	khẩn
箭	tiễn,tiến
郁	úc,uất
泫	huyễn,huyên
鲢	liên
漏	lâu,lậu
侇	di
硝	tiêu
吴	ngô
霈	bái
蠵	huê
鬟	hoàn
嶽	nhạc
攤	than
摶	chuyên,đoàn
峯	phong
聒	quát
管	quản
鶘	hồ
祋	đoái
狾	chế
钎	thiên
戟	kích
冂	quynh
騰	đằng
軀	khu
跮	sí
纲	cương
礩	chí,chất
搘	chi
傢	gia
坴	lục
穸	tịch
牧	mục
灈	cù
俩	lưỡng
霩	khuếch
吠	phệ
裢	liên
结	kết
蠾	chúc
髲	bị
酌	chước
觙	cô
鯰	niềm,niêm
韺	anh
線	tuyến
撞	chàng,tràng
吝	lận
鎖	tỏa
枥	lịch
諤	ngạc
屵	ngạt
潗	tập
鄎	tức
戩	tiễn,tiển
狉	phi
塾	thục
箑	tiệp
鱓	thiện,đà,lưu
皲	quân
滈	hạo,hao
赦	xá
礄	kiều
帻	trách
鈦	thái
澭	ung
鍐	tông
誒	hy,ai
躺	thảng
瓨	giang
豐	phong
煁	thầm,thâm
礚	khái
溚	tháp
缉	tập
轢	lịch
铝	lữ
夯	bổn,kháng,hãng
畚	bổn,bản
猋	tiêu
涨	trướng
爁	lãm
柍	ương,anh
飁	tập
碛	thích
羓	ba
氅	xưởng,sưởng
基	cơ
脃	thúy
働	động
挆	đỏa
缰	cương
奬	tưởng
褓	bảo
琐	tỏa
镈	bác
騥	nhu
橛	quyết
薊	kế
滋	tư
矙	khám
塒	thì
蓡	sâm
巵	chi
跼	cục
鹥	ê
伄	điếu
鎧	khải
蹽	liêu
璨	xán
壜	đàm
金	kim
咉	ương
洁	khiết
鵑	quyên
掝	hoặc
鸮	hào
罠	mân
赚	trám
药	dược,ước,điếu
曼	mạn,man
僗	lao
緁	tiệp
贠	viên
苅	ngải
啴	xiển,than
籺	hột
鸄	kiếu
渍	tý,tí
裾	cư,cứ
趈	trạm
砅	lệ
稸	súc
殞	vẫn
虞	ngu
丑	xú,sửu
匡	khuông
爍	thước
翨	sí
妙	diệu
駵	lưu
囀	chuyển
懙	dư
圗	đồ
悆	dự
僋	thám
闡	xiển
蕱	sao
愰	hoảng
椇	củ
淋	lâm
榔	lang
鼃	oa
峭	tiễu
讜	đảng
廐	cứu
翚	huy
劉	lưu
僚	liêu
帣	quyến
秀	tú
栨	thứ
纂	toản
坍	than
兽	thú
翂	phân
釧	xuyến
哳	triết
薮	tẩu
陟	trắc
埴	thực
邾	chu
悐	thích
挹	ấp
鹜	vụ
稑	lục
郐	cối
阞	lặc
矩	củ
配	phối
鐠	phổ
滓	chỉ
怒	nộ
婓	phi
試	thí
鸋	ninh
吚	y
饕	thao
寫	tả
維	duy
乢	cái
耀	diệu
湾	loan
蘋	bình,tần
跹	tiên
念	niệm
緉	lưỡng
穇	sam,sâm
遐	hà
窞	đạm,nảm,đảm
鲳	xương
裞	thuế
怭	tất
皜	hạo,cảo
夃	cô
股	cổ
鼠	thử
跤	giao
姑	cô
舨	bản
臄	cược
宇	vũ
哗	hoa
閥	phiệt
踫	bính
氰	tình
譚	đàm
駘	đãi,thai,đài
洼	oa,khuê
婪	lam
気	khí
衤	y
璦	ái
勦	tiễu
祢	nễ,nỉ
偢	thu,tiễu,thiễu
珐	pháp
浡	bột
嫡	đích
睜	tranh,tĩnh
霙	anh
簌	thốc,tốc
初	sơ
畟	tắc
橿	cương
碒	ngâm
隩	úc,áo
芲	hoa
筅	tiển
毧	nhung
岌	ngập
店	điếm
嬝	niễu,niệu
垆	lư,lô
撊	giản
蝶	điệp
驖	thiết
螃	bàng
堿	dảm,kiềm,thiêm,kiểm
橐	thác
篡	thoán,soán
擊	kích
檛	qua,choa
彾	linh
齔	sấn
铯	sắc
铌	ni
挂	quải
箪	đan,đạm
團	đoàn
紗	sa
氵	thủy
龅	bao
旻	mân
矐	hoắc
阐	xiển
檄	hịch
矟	sác,sóc,sáo
揄	du
麵	miến
飕	sâu,sưu
页	hiệt
塏	khải
譊	nao
罺	trào
佂	chinh
鼎	đỉnh
甀	trụy
鎝	táp
鷾	ý
徐	từ
片	phiến
弗	phất
袋	đại
匍	bồ
倕	thùy
灥	tầm,tuyền
躑	trịch
箍	cô
懜	mộng
鬇	tranh
线	tuyến
颦	tần
慠	ngạo
雙	song
聅	xỉ,đàn
訰	chuẩn
脉	mạch
鬝	gian
罃	oanh
夜	dạ,dịch
宪	hiến
牮	tiến
畫	hoạch,họa
趖	toa
螳	đường
缢	ải
暬	tiết
嫻	nhàn
孻	nai
俪	lệ
紮	trát
鹃	quyên
缌	ty,ti
蒦	hoạch
忄	tâm
碑	bi
餦	trương
盆	bồn
鷉	đề
驹	câu
溠	trá,tra
醰	đàm
瞒	môn,man
凯	khải
誅	tru
袛	đê
锑	đễ
倌	quan
螴	trần
轝	dư
覩	đổ
烕	diệt
葵	qùy
踊	dũng
惴	chúy
莔	hồi,manh
圪	khất
嗜	thị
尤	vưu
慭	ngận
蠛	miệt
罕	hãn
鯢	nghê
醹	nhu
黝	ửu
旋	toàn,tuyền
疾	tật
燖	tầm
濶	khoát
鲌	bạc
怷	truật
倀	trành
牍	độc
餄	hợp
鳅	thu
扞	cản,cán,hãn
嫌	hiềm
狡	giảo
幪	mông
音	âm,ấm
紑	phù,phủ
秭	tỷ,tỉ
螻	lâu
臀	đồn
讴	âu
揎	tuyên
蚅	ách
鹾	ta
喣	hú
蝭	đề
菠	ba
馵	chú
唿	hốt
鸘	sương
鹴	sương
灠	lạm,lãm
朒	nục
彉	khoắc
低	đê
鬥	đấu
刮	quát
銥	y
鐋	thảng
丕	phi
赟	uân
聳	tủng
嶾	ẩn,nhạc
聧	khuê
嫣	yên
徭	dao
蛝	hàn
喇	lạt
抗	kháng
嘤	anh
麙	hàm
镧	lan
牜	ngưu
斥	xích
骭	cán
絡	lạc
鉤	câu
捕	bổ,bộ
訪	phỏng,phóng
愇	vĩ
麅	bào
辌	lương
諱	húy
顥	hạo,hiệu
鳸	hỗ
瀄	trất
栄	vinh
巫	vu
糾	kiểu,củ
梳	sơ
弣	phủ
麹	khúc
靖	tịnh,tĩnh
噚	tầm
蛄	cô
睑	kiểm
灌	hoán,quán
蕠	như
漵	tự
婚	hôn
赀	ty,ti
稖	bang
狎	hiệp
鈹	phi
遭	tao
蟘	đặc
戥	đẳng
黩	độc
鑊	hoạch
缺	khuyết
噞	nghiệm
鶂	nghịch
嗀	hác
燃	nhiên
謐	mật,mịch
餸	tống
筰	tạc
捔	giác,trác
蚈	khiên
跄	thương
撳	khấm
滢	huỳnh
湱	hoạch
蘭	lan
鍑	phúc
剮	qủa
蛞	quát,khoát
殤	thương
蝯	viên
嬬	nhu
鲮	lăng
姜	khương
磐	bàn
杌	ngột
叫	khiếu
康	khương,khang
軸	trục
萧	tiêu
臝	lõa,lỏa
縏	bàn
癩	lại
戁	nản,nãn,nạn
鉎	sinh
澠	mẫn,miễn,mãnh,thằng
幑	huy
辆	lạng,lượng
伻	bình
敁	điêm
嫋	niễu,niệu
嘏	hỗ
附	phụ
瘌	lạt
绀	cám
葊	am
签	thiêm
祸	họa
舒	thư
圊	thanh
爾	nhĩ,nễ
鐳	lôi
璋	chương
认	nhận
躣	cù
犵	khất,ngật
痟	tiêu
鬏	thu
愐	miễn
臎	thúy
焂	thúc
锦	cẩm
螮	đế
豵	tông
叱	sất
飍	hu
軛	ách
殼	xác
莒	cử
沓	đạp
区	khu,âu
裉	khẳng
怎	trẩm,chẩm
蓷	suy,thôi
𦒝	hảm
鹁	bột
飶	tất
況	huống
話	thoại
桷	giác
謬	mậu
茷	phệ,bái
竊	thiết
帨	thuế
譶	đạp
撵	niện
蘂	nhụy,nhị
虆	luy
郎	lang
漭	mãng
韃	thát
壙	khoáng
腓	phì
烯	hy
戯	hí,hý
谟	mô
疃	thoản
皑	ngai
钊	chiêu
轭	ách
拙	chuyết
鈷	cổ
溳	vân
轉	chuyển,chuyến
詢	tuân
駞	đà
甪	lộc,lộ
鬰	uất
龌	ác
秦	tần
饷	hướng
璱	sắt
畈	phiến,phán
贒	hiền
莚	diên
録	lục
鄄	quyến,quyên
帬	quần
貗	lâu
掤	băng
熖	diễm
侳	tóa
毄	kích
猙	tranh
稭	giai,kiết
苽	cô
馎	bác
䉍	giản,manh
斲	trác
寥	liêu
觚	cô
荃	thuyên
掦	thích
憖	ngận
垤	điệt
傚	hiệu
铰	giảo
苁	thung
習	tập
玥	nguyệt
攉	hoắc
淯	dục
眳	danh
乏	phạp
面	miến,diện
躄	tích
芦	lư,lô
滤	lự
鳩	cưu
瘝	quan
厰	xưởng
辏	thấu
骫	ủy
柛	thân
閜	há
毡	chiên
槳	tưởng,tương
竅	khiếu
蚨	phù
窱	điệu
耚	phi
糰	đoàn
矕	mãn
銗	hạng
躩	khước,quặc
衙	ngữ,nha
嚆	hao
籊	địch,ti4
秔	canh
岖	khu
競	cạnh
偉	vĩ
杲	cảo
鄴	nghiệp
态	thái
駊	phả
勹	bao
籪	đoán
瓢	biều
鬩	huých
孛	bột
袞	cổn
鉵	đông
翻	phiên
猳	gia
鯪	lăng
覤	khích
喭	ngạn
组	tổ
缑	câu
蘦	linh
厀	tất
料	liêu,liệu
囵	luân
繫	hệ
佷	ngận,hận
艚	tào
盱	hu
沜	phán
醉	túy
鬲	lịch,cách
檼	ẩn
蒻	nhược
簼	câu
踑	ky
賖	tha
苖	địch,miêu
掫	chu,tâu,tưu
汛	tấn
薷	nhu
檇	tuy
癸	qúy
缽	bát
惯	quán
詷	đồng
砮	nỗ
抈	nguyệt
脭	trình
蒸	chưng
寍	ninh
磤	ân
茢	liệt
嵾	sâm
鏤	lũ
艣	lỗ
鞏	củng
餑	bột
撥	phạt,bát
幔	mạn
慅	tao,tháo
沅	nguyên
慵	dong,thung,dung
屳	hiên
搽	trà
縟	nhục
滱	khấu
闘	đấu
骺	hầu
蠅	dăng
螙	đố
鯆	phô
豝	ba
轅	viên
觎	du
浅	thiển,tiên
墙	tường
铪	cáp
燜	muộn
修	tu
恆	cắng,hằng,căng
屮	triệt
芎	khung
锚	miêu
朿	thứ
憔	tiều
堊	ác
鸱	si
骯	khảng
攞	lõa,la
跅	thác
涹	oa,ủy
嶢	nghiêu
恇	khuông
飞	phi
鄤	mạn
釁	hấn
鰾	phiêu
卜	bặc,bốc
祻	cố
忣	cấp
飃	phiêu
捗	duệ
綫	tuyến
蠻	man
袧	khu
逝	thệ
墓	mộ
棯	nhẫm
邓	đặng
癎	giản
坳	ao
脆	thúy
鮷	đệ
辋	võng
渔	ngư
籋	nhiếp
涘	sĩ
靈	linh
幐	đằng
齲	khủ,củ
谤	báng
枯	khô
慥	tháo
骚	tao
囶	quốc
誃	xỉ
茌	trì
藁	cảo
笸	phả
擻	tẩu
锛	bôn
仑	luân,lôn
铽	thắc
塌	tháp
匠	tượng
爨	thoán
詥	cáp
蛲	nhiêu
螊	hiềm
槸	nghệ
跏	già,gia
狀	trạng
縈	oanh
馐	tu
牐	sáp
贜	tang
瑮	lật
鶓	miêu
晜	côn
嗥	hào
榥	hoảng
抚	mô,phủ
乩	kê
坣	đường
憛	đàm
赃	tang
愓	đãng
暑	thử
脊	tích
叅	xam,tham
軯	phanh
邉	biên
猿	viên
嘱	chúc
贗	nhạn
絹	quyên
豤	khẩn
戫	vực,úc
檻	hạm
盍	hạp
祠	từ
畡	cai
祳	chấn
紿	đãi
鋧	hiện
灅	lũy
搡	táng
縶	trập
疌	tiệp
腤	am
帤	như
肂	tứ
簎	trách
晁	triều,trào
隂	âm
島	đảo
葼	tông
啵	ba
遡	tố
漩	tuyền
憍	kiêu
屆	giới
袟	trật,dật
遽	cự
氥	tây
戽	hố,hỗ
釵	sai,thoa
䁖	lâu
焚	phẫn,phần
卣	dữu
揱	sóc
浻	quýnh
邽	khuê
福	phúc
諠	huyên
闋	khuyết
弈	dịch
呐	niệt,nột
籑	soạn
升	thăng
玳	đại
羣	quần
膰	phần,phiền
艎	hoàng
摀	ô
箎	trì
苞	bao
茯	phục
貨	hóa
襈	soạn
箝	kiềm
琼	quỳnh
頉	di
鄩	tầm
闕	quyết,khuyết
弮	khuyên
擫	áp
讓	nhượng
駷	tẩu
凟	độc
瘗	ế
侫	nịnh
麮	khứ
聲	thanh
噵	đạo
匋	đào
祪	qủy
欙	luy
犭	khuyển
刈	ngải
趦	tư
溲	sưu,sửu
將	tướng,thương,tương
窍	khiếu
峳	du
藻	tảo
皡	hạo
巓	điên
鮕	cố
倱	hỗn
磪	thôi
驞	phân
坄	dịch
糸	mịch
腋	dịch
皭	tước
宴	yến
蛣	kiết
勻	quân
抛	phao
鍔	ngạc
唈	ấp
澺	ức
倜	thích
鹔	túc
坺	bạt
辇	liễn
涂	đồ
稳	ổn
樻	qũy
筘	khấu
稼	giá
冯	phùng,bằng
縠	hộc
氱	dưỡng
鼜	thích
殖	sự,thực
蝱	manh
犤	bi
楮	chử
齏	tê
跈	tiễn
昪	biện
蹝	sỉ
襺	kiển
濲	cốc
简	giản
鑠	thước
墣	phác
旗	kỳ,kì
硐	động
匸	hệ,hễ
獿	nao
鼽	cừu
蠱	cổ
啢	lạng,lượng
绂	phất
疫	dịch
寿	thọ
摜	quán
萴	trắc
霪	dâm
赎	thục
钼	mục
聊	liêu
湟	hoàng
蓿	túc
奞	tuy
浽	tuy
聮	liên
锼	sưu
鳽	khiên
蚇	xích
赠	tặng
怲	bính
諙	thoại
踮	điểm
穫	hoạch
悋	lận
啭	chuyển
铐	khảo
赮	hà
瓩	thiên ngõa
笭	linh
頤	di
煑	chử
蘝	liêm,liễm
輣	bành
襦	nhu
截	tiệt
濋	sở
慞	chương
醮	tiếu
驫	bưu
埠	phụ
奥	úc,áo
攙	sam
襳	sâm,tiêm
卐	vạn
译	dịch
閷	sát
趮	táo
弋	dặc
昒	hốt
棸	trâu
諝	tư
轚	kích
栰	phạt
肐	cách
姪	điệt
襾	á
梪	đậu
綎	đinh
緵	tông
笕	kiển
珌	tất
铏	hình
熳	mạn
戍	thú
憪	hàn
䃅	đê
嘼	súc
矹	ngột
璿	tuyền
槛	hạm
牋	tiên
櫻	anh
黆	quang
蹳	bát
稾	cảo
媢	mạo
縮	súc
汳	biện
斫	chước
滼	phạm
醥	phiếu
藦	ma
豃	hãm
楱	thấu
儛	vũ
伍	ngũ
慂	dũng
娟	quyên
寛	khoan
汪	uông
烚	hiệp
攇	hiến
嬰	anh
訟	tụng
囑	chúc
獢	kiêu
钖	dương
屃	hý
睹	đổ
暮	mộ
泮	phán
儸	la
庥	hưu
琶	bà
牆	tường
麔	cữu
阘	tháp
腥	tinh
釓	ca
觕	thô
禚	chước
劢	mại
執	chấp
賔	tân
礓	cương
聹	ninh
喌	châu
墶	đáp
妘	vân
弨	siêu
僭	tiếm
捌	bát
悷	lệ
娢	hàm
洰	cự
泝	tố
挎	khóa,khô
涾	đạp
罛	cô
龚	cung
呈	trình
齱	châu
禴	dược
舶	bạch,bạc
章	chương
齻	điên
槚	giả
娠	thần
顪	hối
殠	hú
姧	gian
籝	doanh
沟	câu
贤	hiền
哴	lang
罝	ta,tư
颋	đĩnh
篲	tuệ
耮	lạo
叢	tùng
児	nhi
藳	cảo
啪	ba
慛	thôi
谰	lan
芈	mị,nhị
鷸	duật,thuật
氨	an
遄	thuyên
烷	hoàn
榱	suy
柯	kha
餧	nỗi,ủy
譁	hoa
謻	di
豲	nguyên
叮	đinh
熀	hoảng
堎	lăng
懣	muộn
楽	lạc
閹	yêm
岗	cương
趄	thư,thiết
廗	đái
浚	tuấn
苗	miêu
鬤	nhương
懼	cụ
輩	bối
惵	điệp
泬	quyết
笠	lạp
袲	di
臗	khoan
傃	tộ
榭	tạ
疴	kha,a
翾	huyên
眵	si
阜	phụ
铥	đâu
饶	nhiêu
嶝	đặng
震	chấn,thần
甖	anh
饙	phân
噐	khí
蔦	điểu
米	mễ
邗	hàn
环	hoàn
杰	kiệt
姎	ương
泽	trạch
究	cứu
郹	kích
葋	cù
息	tức
豘	đồn
麤	thô
暄	huyên
範	phạm
鱷	ngạc
劦	hiệp
豑	trật
枞	tung
澮	quái
厺	khứ
诗	thi
罚	phạt
笲	phiền
煸	biên
瘁	tụy
栻	thức
廁	trắc,xí
坒	bệ
詉	nao
舞	vũ
喾	khốc
礻	thị
鲼	phẫn
鬌	đọa,đỏa
闭	bế
嬷	mụ,ma
蚣	công
鳘	mẫn
眄	miện
眐	chính
轼	thức
嘠	dát
凙	đạc
喓	yêu
噷	hâm
裔	duệ
匿	nặc
商	thương
庭	đình,thính
敔	ngữ
鈑	bản
吢	khấm
焓	hàm
甽	quyến
鍥	khiết
旨	chỉ
鐇	phiên
零	linh
倳	trị
沄	vân
赝	nhạn
贶	huống
雟	tủy,huê
鸵	đà
髬	phi
铳	súng
籹	nhữ
韰	giới
彩	thể,thái,thải
飥	thác
襋	cức
朅	khiết
仕	sĩ
銮	loan
翹	kiều
鈒	táp
涓	quyên
鰕	hà
颒	hối
憒	hội
獅	sư
峫	da
禅	thiền,thiện
唢	tỏa
垜	đóa
趔	liệt
竮	phinh
諉	dụy,ủy
璊	môn
訇	hoanh
湎	miện
烊	dương
肈	triệu
链	liên
宀	miên
珵	trình,thỉnh
僷	diệp
朄	dẫn
剸	chuyên,chuyển
饔	ung
肢	chi
傹	cương
琀	hàm
嘩	hoa
輇	thuyên
拹	hiếp
阒	khuých
雱	bàng
蛻	thuế
縝	chẩn
爌	hoảng
蹯	phiền
罔	võng
絝	khố
样	dạng
鷮	kiều
绻	quyển
灳	linh
髈	bảng
膑	tẫn,bận
澡	táo,tháo
盔	khôi
谭	đàm
奅	pháo
匪	phỉ
轸	chẩn
謄	đằng
銖	thù
鈽	bố
琗	tối
迾	lệ
包	bao
曬	sái
撙	tỗn,tổn
藿	hoắc
絆	bán,bạn
舣	nghĩ
棁	chuyết
匭	qũy
啍	ngôn,truân,thôn
樯	tường
伈	tẩm
齶	ngạc
袎	áo
潾	lân
获	hoạch,địch
廄	cứu
翩	phiên
亯	hanh
笔	bút
櫖	lự
辺	biên
詵	sân
鉟	phi
盏	trản
澞	ngu
鷣	dâm
竛	linh
增	tăng
瞜	lâu
鄆	vận
裂	liệt
鋤	sừ
酳	dận
暫	tạm
坤	khôn
訆	khiếu
獸	thú
捫	môn
瘦	sấu
铂	bạch,bạc
磥	lỗi
鮠	ngôi,nguy
詗	huýnh,quýnh
藜	lê
禄	lộc
诏	chiếu
筲	sao
庚	canh
曈	đồng
佌	thử
拽	duệ
鑕	chất
痉	kinh
逸	dật
懴	sám
鷈	đề
龁	hột
谓	vị
妫	quy
醴	lễ
欖	lãm
狟	hoàn
襲	tập
鷊	nghịch
騐	nghiệm
袺	kết
蜜	mật
踞	cứ
覿	địch
狹	hiệp
氧	dưỡng
脗	vẫn
吲	sẩn
冈	cương
岹	thiều
鐀	qũy
谴	khiển
珡	cầm
卑	ty,ti
颇	pha,phả
刹	sát
诲	hối
軘	đồn
搲	oa
鉴	giám
䍽	lịch
蠣	lệ
锵	thương
瀴	anh
筼	vân
蜲	uy
觼	quyết
磈	ủy
楡	du
憜	đọa
酷	khốc
鱻	tiên
饈	tu
饸	hợp
宦	hoạn
阳	dương
蚞	mộc
昬	hôn
鼓	cổ
油	du
嗝	cách
恠	quái
虻	manh
鈈	bất
怢	đột
潨	tùng
羚	linh
縑	kiêm
胛	giáp
秩	trật,dật
贳	thế
勔	mẫn,miễn
閉	bế
疄	lân
倸	thải
滝	long
废	phế
枬	nam
浞	trác
鬺	thương
漠	mạc
錫	tích
塩	diêm
呓	nghệ
洱	nhĩ,nhị
糲	lệ
誥	cáo
艭	sang
狷	quyến
迿	tuân
囂	hiêu
峩	nga
酸	toan
箬	nhược
穄	tế
栯	hữu
洛	lạc
蜧	luân
臤	khiên
紝	nhâm
坎	khảm
塄	lăng
飌	phong
颐	di
崞	quách
刭	hĩnh
采	thái,thải
籌	trù
弢	thao
铱	y
呋	phu
耦	ngẫu
凰	hoàng
颥	nhu
譇	xa
驯	tuần
廴	dẫn
趽	bành
扤	ngột
剌	lạt
坑	khanh
瞶	qúy
浰	lợi
圩	vu
陔	cai
巉	sàm
惼	biển
袦	quật
鶬	thương
襎	phiên
逰	du
諺	ngạn
租	tô
棜	ứ
騬	tăng
羕	dạng
词	từ
慺	lâu
亊	sự
阋	huých
揞	yêm
霃	trầm
霒	âm
躉	độn
第	đệ
崷	tù
痢	lị
穎	dĩnh
昷	ôn
跗	phu,phụ
隘	ách,ải
巢	sào
摴	sư,xư
芥	giới
嬋	thiền,thuyền
鞚	khống
缩	súc
蹣	man,bàn
庨	hao
钲	chinh
蹿	thoan
哇	oa
墩	đôn
顳	nhiếp
隉	niết
鏖	ao
娯	ngu
輝	huy
皦	kiểu
駉	quynh
俁	ngu,vũ
廥	quái
鱒	tôn,tỗn
躞	tiệp
杈	sá,xoa
舄	tích
湽	truy
轮	luân
聓	tế
昲	phí
挴	mỗi
憦	lạo
蝐	mội
胐	đốt
鋅	tử,tân
皾	độc
藣	bi
軖	khuông
滽	dung
腄	chủy
氹	đãng
轡	bí
鉜	phù
鋵	ngốc
矆	hoạch
靮	đích
碜	sầm
蟺	thiện
鵡	vũ
专	chuyên
焰	diễm
榈	lư
菤	quyển
歠	xuyết
岧	thiều
蜾	qủa
峚	mật
鏩	tiệm
炼	luyện
耝	thư
囏	gian
郘	lữ
记	ký,kí
焜	hỗn,côn
互	hỗ
達	đạt
鲟	tầm
笫	chỉ
彎	loan
樛	cù
薘	đạt
矰	tăng
毃	khác
飐	triển
蒟	củ
𤟹	ngụ
賒	xa
獚	hoàng
薿	nghĩ
脫	thoát,đoái
芬	phân,phần
仡	ngật
畆	mẫu
畋	điền
謳	âu
姘	phanh
萄	đào
髾	sao
恹	yêm
墻	tường
瘀	ứ
绯	phi
簂	quắc
递	đái,đệ
萤	huỳnh
罎	đàm
鬘	man
壞	hoại,hoài
檜	cối
勣	tích
峻	tuấn
搐	súc
躰	thể
眀	minh
諵	nam
孕	dựng
痨	lao
愗	mậu
橄	cảm
宬	thành
郲	lai
艙	thương
銎	khung
溆	tự
鑄	chú
籦	chung
醼	yến
粲	sán,xán
樞	xu
叆	ái
瑽	xung
恬	điềm
醩	tao
鄝	liễu
冋	quynh
粤	việt
悟	ngộ
級	cấp
卋	thế
垗	triệu
窜	thoán,soán
躃	tích
讎	thù
窺	khuy
樿	thiện
癅	lựu,lưu
蒙	bàng,mông
襓	nhiêu
蓋	cái,hạp
郧	vân
婬	dâm
偺	cha,tảm
攓	kiển
憾	đảm,hám
乌	ô
盟	minh
灏	hạo
廷	đình
寺	tự
莺	oanh
擾	nhiễu
蹠	chích
製	chế
壕	hào
学	học
牉	phán
槀	cảo
衺	tà
樆	ly
噬	phệ
絨	nhung
虬	cầu
崑	côn
鎿	nã
锽	hoàng
珩	hành
湦	sinh
扵	ư
揘	niết,hoành
臞	cù
獥	kích
滆	hách
鲎	hấu
甶	phất
鼕	đông
駪	sân
嫷	đọa
光	quang
炱	đài
鐸	đạc
筵	diên
珠	châu
瀏	lựu,lưu
掛	quải
歅	nhân
衽	nhẫm
蕚	ngạc
晷	qũy
餗	tốc
剱	kiếm
癬	tiển
毁	hủy
阡	thiên
庌	nhã
垽	ngấn
軃	đả
吪	ngoa
蚿	huyền
冖	mịch
雛	sồ
俷	phị
詨	giáo
囧	quýnh
軱	cô
据	cư,cứ
溻	thạp
岁	tuế
苘	quýnh,khoảnh
鉬	mục
寝	tẩm
侚	tuẫn
怆	sảng
槓	cống
崍	lai
練	luyện
训	huấn
蠘	tiệt
谀	du
樀	đích
楶	tiết
胹	nhi
踂	nhiếp
謣	vu
撡	thao
睃	tuấn
巅	điên
黀	tưu
鹭	lộ
汧	khiên
鳜	quyết
㧜	liệp
脿	biểu
甝	hàm
尙	thượng
嗼	mạc
壴	trú
旼	mân
螯	ngao
荒	hoang
嬎	phó
徧	biến
駐	trú
櫔	lệ
鶃	nghịch
騜	hoàng
薆	ái
嘓	quắc
犆	đặc
溵	ân
磞	phanh
埂	canh
鉗	kiềm
随	tùy
氦	hợi
氀	lâu
蕤	nhuy
畿	kỳ,kì
豬	trư
螬	tào
隤	đồi
搆	cấu,câu
褧	quýnh
瞝	si
𪠳	xa
鬦	đấu
球	cầu
酧	thù
赒	chu
匱	qũy
贋	nhạn
驲	nhật
拈	niêm
艦	hạm
愧	qúy
嶸	vanh
瓖	tương
諈	chủy
秉	bỉnh
袯	bát
釜	phủ
嗉	tố
詇	ưởng,ánh
橅	mô
梏	cốc
輘	lăng
榄	lãm
箩	la
錴	lục
门	môn
蚋	nhuế
焤	hủ
幠	hu
筢	ba
略	lược
镍	niết
躔	triền
窦	đậu
缷	tá
笘	thiêm
鴥	duật
滞	trệ
匵	độc
偎	ôi
惌	uyên
褦	nại,lặc
羽	vũ
旉	phu
旡	ký,vô,kí
隈	ôi
噡	chiêm
篝	câu
跎	đà
𣠺	tiếp
妈	mụ,ma
铹	lao
遅	trì
完	hoàn
乂	nghệ
谶	sấm
酓	đàm
駍	phanh
嫭	hộ
軾	thức
稻	đạo
笆	ba
飭	sức
笞	si
綘	phùng
圝	loan
库	khố
栲	khảo
瞧	tiều
埧	cụ
幇	bang
釣	điếu
穛	tróc
袘	dị
窾	khoản
肝	can
粦	lân
螫	thích
缱	khiển
猨	viên
胨	đống
搦	nhược,nạch
瘿	anh
压	áp
潖	bà
黽	mẫn,mãnh,miễn
瀡	tủy
堯	nghiêu
壖	nhuyên
疯	phong
靫	xoa
鶤	côn
鸸	nhi
啖	đạm
卉	hủy
瀍	triền
昨	tạc
僦	tựu
澎	bành
逕	kính
嬢	nương
窓	song
得	đắc
綑	khổn
船	thuyền
觺	nghi
佽	thứ
秤	xứng
辄	triếp
鏗	khanh
驀	mạch
扬	dương
槖	thác
瑌	nhuyễn
駣	đào
鯹	tinh
偶	ngẫu
吩	phân
枳	chỉ
荔	lệ
褕	du
鱽	đao
苧	ninh,trữ
址	chỉ
掘	quật
繮	cương
艋	mãnh
傔	khiểm
邸	để
翌	dực
泉	toàn,tuyền
萅	xuân
欓	đảng
檩	lẫm
鎭	trấn
郞	lang
鞫	cúc
倖	hãnh
悃	khổn
笥	tứ
辑	tập
麩	phu
蜩	điêu
剬	đoan
鍪	mâu
裗	lưu
鹙	thu
泃	cú
楓	phong
鳒	kiêm
徘	bồi
逺	viễn
槺	khang
魂	hồn
唧	tức
鷳	nhàn
睬	thải
獯	huân
棂	linh
侼	bột
侲	chấn
嵝	lũ
駏	cự
烏	ô
謋	hoạch
黍	thử
河	hà
麥	mạch
潜	tiềm
杯	bôi
麆	sự
酟	thiêm
驡	long
癡	si
顤	nghiêu
顿	đốn
裻	đốc
屜	thế
臛	hoắc
痵	qúy
匏	bào,biều
櫓	lỗ
筠	quân
普	phổ
珂	kha
梣	sầm
箔	bạc
齵	ngu
嘦	khiếu
述	thuật
俏	tiêu,tiếu
婭	á
贼	tặc
恀	thị
攸	du
𦒨	lạo
簪	trâm
瀖	hoắc
夺	đoạt
閑	nhàn
躜	toàn
沪	hỗ
挞	thát
獒	ngao
煚	quýnh
艵	phanh
韣	độc
賙	chu
旂	kỳ,kì
哦	nga
餱	hầu
埢	quyền
扌	thủ
嬙	tường
偒	dị
腠	thấu
墺	úc,áo
逮	đãi,đệ
膄	sấu
纔	tài
甙	đại
躲	đóa
镣	liêu
鰈	điệp
咙	lung
碎	toái
局	cục
渝	du
舤	hàng
泼	bát
諒	lạng,lượng
伊	y
鍦	thi
蹕	tất
綈	đề
𠀇	thả
蘑	ma
刑	hình
鸨	bảo
硶	sầm
拦	lạn,lan
鄡	kiêu
鶢	viên
鐝	quyết
罟	cổ
桹	lang
骥	ký,kí
刎	vẫn
毢	tai
斵	trác
憸	tiêm
盂	vu
喱	ly
懡	mạ
卿	khanh
肼	tỉnh
茁	truất
颓	đồi
鶆	lai
击	kích
疲	bì
宎	yểu
腛	ác
壒	ái
蝾	vinh
拎	linh
灝	hạo
憫	mẫn
賺	trám
胞	bào
送	tống
匟	kháng
媳	tức
攕	tiêm
儾	nang
璺	vấn
奮	phấn
镴	lạp
悪	ác
剁	đóa
半	bán
産	sản
妾	thiếp
櫙	ất
郵	bưu
悛	thuyên,thuân
傽	chương
瓝	bạc
斨	thương
矊	miên
缒	trúy
雜	tạp
鼞	thang
郪	thê
肹	hật
喨	lượng
榰	chi
懈	giải
揠	yển,yết
昀	quân
訿	tý
嬀	quy
趗	xúc
惦	điếm
堧	nhuyên
挠	nạo
帛	bạch
鞼	qũy
敨	đẩu,thầu
泅	tù
碉	điêu
胵	si
褋	điệp
嫏	lang
馭	ngự
朡	tông
鮦	đồng
輓	vãn
逩	bôn
醜	xú
铣	tiển
励	lệ
鋇	bối
醆	trản
恪	khác
賨	tung
惲	uẩn
寑	tẩm
彘	trệ
鲊	trá,trả
坶	mộc,mẫu
套	sáo
舌	thiệt
挪	na
峉	ngạch
叔	thúc
蟾	thiềm
汭	nhuế
寃	oan
皰	pháo
熥	thông
瞍	tẩu
鼅	tri
狗	cẩu
焙	bồi
鐗	giản
狼	lang
史	sử
寢	tẩm
掼	quán
鞶	bàn
弦	huyền
衈	nhị
詅	linh
婣	nhân
薬	dược
搀	sam
郟	giáp
紘	hoành
鴳	yến
掾	duyện
萌	manh
綾	lăng
菺	kiên
悤	thông
嫶	tiều
閡	ngại
玈	lô
錬	luyện
樝	tra
邟	kháng
纩	khoáng
畧	lược
叕	chuyết
臽	hãm
晦	hối
鋨	nga
謿	trào
歳	tuế
岩	nham
嫂	tẩu
屑	tiết
鸚	anh
豥	cai
星	tinh
鲏	bì
晔	diệp
型	hình
涿	trác
鄯	thiện
畺	cương
苤	phiết
榑	phù
樐	lỗ
蝮	phúc
侶	lữ
礼	lễ
玆	tư
豰	hốc
溷	hỗn
霏	phi
溹	sách,tác
虗	hư
屝	phỉ
掳	lỗ
蹀	điệp
駴	hãi
讳	húy
雘	hoạch
顒	ngung
搞	cảo
盄	chiêu
满	mãn
狯	quái
棃	lê
顴	quyền
盦	am
鄱	bà
臲	niết
噶	cát
穴	huyệt
翲	phiêu
蝘	yển
鰟	bàng
聩	hội
週	chu
仄	trắc
羖	cổ
锉	tỏa
楉	nhược
侑	hựu
鶯	oanh
颚	ngạc
臓	tạng
疕	phỉ
氟	phất
藾	lại
鑞	lạp
阮	nguyễn
蚼	câu
癤	tiết
髠	khôn
鷋	đồ
裈	côn
栳	lão
謱	lâu
擢	trạc
蚛	trọng
鱨	thường
淦	cam
攆	niện
詫	sá
蒍	vị
蕷	dự
院	viện
狘	huyết
粜	thiếu
灦	hiển
嬡	ái
眚	sảnh
驓	tặng
皂	tạo
檊	cán
勘	khám
豇	giang
測	trắc
證	chứng
勲	huân
躟	nhương
郾	yển
佹	qủy
杇	ô
繙	phiên
墫	tôn
闾	lư
芷	chỉ
腖	đống
怟	kỳ
骐	kỳ,kì
㒸	toại
铄	thước
遷	thiên
脹	trướng
社	xã
潎	bệ
帢	kháp
滖	tuy
茶	trà
隠	ẩn
录	lục
齖	nha
腒	cừ
酘	đầu
鞣	nhu
霨	úy
龂	ngân
刘	lưu
饺	giáo,giảo
苐	đệ
𣴓	kạn
黧	lê
槮	sâm
睩	lộc
媥	thiên
鍁	hân
荆	kinh
螡	văn
柒	thất
鄳	mãnh
馲	trách
飤	tự
騣	tông
儀	nghi
鞇	nhân
粱	lương
彪	bưu
饱	bão
搌	triển
损	tổn
鮃	bình
颡	tảng
嗁	đề
蕪	vu
栃	lệ
荇	hạnh
秫	thuật
粼	lân
顰	tần
绪	tự
嫄	nguyên
獪	quái
緩	hoãn
朸	lực
锷	ngạc
询	tuân
烺	lãng
沦	luân
旷	khoáng
筟	phu
钣	bản
怵	truật
琏	liễn
谜	mê
禽	cầm
闵	mẫn
镂	lũ
发	phát
賧	đàm
啸	khiếu
棘	cức
椛	hoa
浠	hy
隳	huy
湝	giai
漉	lộc
髊	tỳ
僧	tăng
膃	ột
雾	vụ
姨	di
曙	thự
泖	mão
麞	chương
獂	hoàn
唁	ngạn,nghiễn
雓	dư
傥	thảng
蟨	quyết
榹	ty
鈃	hình
钝	độn
党	đảng
讘	triếp
捴	tổng
丧	tang,táng
囲	vy
昇	thăng
阌	văn
麄	thô
蠁	hưởng
嫳	miết
礙	ngại
旃	chiên
購	cấu
篼	đâu
荽	tuy
坚	kiên
谙	am
簦	đăng
僬	tiêu
埒	liệt
硫	lưu
鑒	giám
皕	bức
溃	hội
廩	lẫm
皀	tấp
砂	sa
璁	thông
鞪	mâu
秷	xứng
殆	đãi
権	quyền
钦	khâm
甈	khế
僔	tổn
醭	phốc
蒺	tật
舴	trách
暹	xiêm,tiêm
艁	tạo
髋	khoan
迣	sế
鼳	kích
嗎	ma,mạ
霡	mạch
鋆	quân
丸	hoàn
职	chức
錚	tranh
慒	tao
餉	hướng
钇	ất
钵	bát
澗	giản
輗	nghê
繝	nhàn
镅	my
窏	ô
厾	đâu
蝚	nhu
餴	phân
洧	vị
钿	điền
鵽	chuyết
亁	can
壢	lịch
顩	nghiễm
嚝	hoành
膳	thiện
槎	tra
嫥	chuyên
歱	chủng
淶	lai
預	dự
揑	niết,nghễ
儺	na
鱝	phẫn
屋	ốc
鸠	cưu
冣	tối
誾	ngân
颽	khải
辠	tội
凹	ao
樱	anh
掍	cổn
靝	thiên
讁	trích
浥	ấp
齉	nang
隓	đọa
継	kế
瞫	thẩm
囹	linh
姓	tính
悒	ấp
眠	miên
嬴	doanh
飇	tiêu
誆	cuống
齬	ngữ
渻	tỉnh
焆	yết
禫	đạm
髷	khúc
侃	khản
胸	hung
愍	mẫn
嗖	sưu
该	cai
豢	hoạn
紼	phất
粵	việt
蟴	tư
煿	bác
齕	hột
増	tăng
脡	đĩnh
換	hoán
吵	sao,sảo
減	giảm
咤	trá,sá
藎	tẫn
弤	để
廌	trĩ,trãi
樷	tùng
川	xuyên
罥	quyến
笐	hàng
壳	xác
牘	độc
盋	bát
氪	khắc
孺	nhụ
荺	vẫn
蓝	lam
栉	trất
锫	bồi
訝	nhạ
螔	di
廏	cứu
秣	mạt
鴿	cáp
訊	tấn
褫	sỉ
胚	phôi
匫	hốt
畣	đáp
严	nghiêm
遂	toại
庐	lư
顬	nhu
藍	lam
咃	tha
伶	linh
籈	chân
貟	viên,vân
絪	nhân
稉	canh
頁	hiệt
㖊	tầm
础	sở
眕	chẩn
礶	quán
狭	hiệp
嵐	lam
諼	huyên
查	tra
鼔	cổ
儊	sứ
髓	tủy
淤	ứ
缓	hoãn
祴	cai
馄	hồn
簹	đương
锎	khai
齩	giảo
鴴	hằng
葓	hồng
诜	sân
沱	đà
鯿	biên
証	chứng
淸	thanh
翳	ế
忒	thắc
珮	bội
刴	đóa
婆	bà
睫	tiệp
衵	nật
蠊	liêm
澁	sáp
魨	đồn
怙	hỗ
梼	đào
驽	nô
衑	linh
恛	hồi
倔	quật
锏	giản
嵩	tung
莅	lị
鹦	anh
鵾	côn
斞	dữu
预	dự
帼	quắc
飜	phiên
肅	túc
厚	hậu
寅	dần
疟	ngược
岒	kiềm
蹸	lận
逑	cầu
磟	lựu
圮	bĩ
桕	cữu
茰	du
啿	đảm
廊	lang
塯	lựu
姝	thù,xu
偬	tổng
鄠	hộ
湖	hồ
麐	lân
釃	sỉ,si
斓	lan
駒	câu
鞯	tiên
漃	tịch
疤	ba
臟	tạng
佬	lão
獕	tỏa
銕	thiết
敭	dương
鼹	yển
傑	kiệt
眸	mâu
曃	đại
轓	phiên
泜	trì
佳	giai
苶	niết
黎	lê
刏	ky
俗	tục
蛭	điệt
尶	giam
妒	đố
瑷	ái
闽	mân
衧	vu
祯	trinh
籕	trứu
肕	nhận
驅	khu
獉	trăn
齸	ích
糺	củ
冥	minh
忽	hốt
禔	đề
呦	u
龃	trở
尸	thi
涔	sầm
阃	khổn
庙	miếu
埃	ai
屦	lũ
潕	vũ
箋	tiên
颺	dương
繭	kiển
懮	ưu
狩	thú
贙	huyễn
蛴	tề
餶	cốt
欐	lệ
籰	dược
耪	bảng
诎	truất
亱	dạ
昚	thận
虡	cự
擬	nghĩ
韇	độc
闩	soan
獱	tân
钨	ô
攬	lãm
闬	hãn
谾	hồng
覦	du
臣	thần
湓	bồn
䫫	lâu
闥	thát
褴	lam
圬	ô
垅	lũng
嶙	lân
濃	nùng
蔏	địch
楃	ác
菙	chủy
鼐	nãi
寜	ninh
抄	sao
櫼	tiêm
斛	hộc
煜	dục
幝	xiển
候	hậu
褟	tháp
倆	lưỡng
钾	giáp
棻	phân
洭	khuông
锌	tân
瞾	chiếu
欨	hu
對	đối
紹	thiệu
噧	hái
馆	quán
旤	họa
畅	sướng
拐	quải
聪	thông
凼	đãng
贡	cống
琱	điêu
鄽	triền
鲗	tặc
蟎	mãn
錄	lục
嵈	hoãn
鋩	mang
眡	thị
刜	phất
娥	nga
戺	sĩ
腞	triện
液	dịch
梃	đĩnh
胏	chỉ
頇	han
汯	hoành
龄	linh
赂	lộ
趎	trù
贈	tặng
摞	loa
岢	khả
諑	trác
瞘	khu
咛	ninh
业	nghiệp
矾	phàn
勽	bão
蔺	lận
郢	dĩnh
鶊	canh
绋	phất
熿	hoàng
庛	thứ
啰	la
鉷	hồng
代	đại
媌	miêu
镨	phổ
姅	bán
客	khách
軗	thù
軎	vệ
簏	lộc
婦	phụ
邀	yêu
冎	qủa
友	hữu
悊	triết
潋	liễm
舰	hạm
籴	địch
岠	cự
璢	lưu
崖	nhai
簖	đoán
唾	thóa
贺	hạ
煽	phiến
愦	hội
儇	huyên
封	phong
轾	chí
踡	quyền
愎	phức
鈁	phương
緖	tự
肓	hoang
匧	kiếp
户	hộ
晚	vãn
乕	hổ
鏜	thang
僴	giản
淽	nhị
惭	tàm
杮	phế
忷	hung
怂	túng,tủng
蔿	vĩ
魗	xú
躯	khu
鎵	gia
楲	uy
尚	thượng
愺	thảo
历	lịch
蔈	phiêu
瓅	lịch
鋃	lang
儕	sài
杨	dương
梁	lương
竖	thụ
羱	nguyên
歔	hư
詬	cấu
硾	trụy
荳	đậu
庼	khoảnh
冦	khấu
漳	chương
簥	kiểu
統	thống
茵	nhân
钡	bối
巠	kinh
兛	thiên khắc
哝	nông
醲	nùng
祜	hỗ
髑	độc
瑣	tỏa
鲋	phụ
鉄	thiết
泇	gia
饯	tiễn
